player,nationality,position,age,minutes_90s,tackles,tackles_won,tackles_def_3rd,tackles_mid_3rd,tackles_att_3rd,dribble_tackles,dribbles_vs,dribble_tackles_pct,dribbled_past,pressures,pressure_regains,pressure_regain_pct,pressures_def_3rd,pressures_mid_3rd,pressures_att_3rd,blocks,blocked_shots,blocked_shots_saves,blocked_passes,interceptions,tackles_interceptions,clearances,errors,matches,team
Pierre-Emerick Aubameyang,ga GAB,FW,30,34.8,39,24,15,14,10,12,50,24.0,38,573,130,22.7,113,256,204,59,2,0,57,11,50,16,0,Matches,Arsenal
David Luiz,br BRA,DF,32,31.2,33,20,22,10,1,10,26,38.5,16,191,66,34.6,143,43,5,63,40,0,23,30,63,183,3,Matches,Arsenal
Bernd Leno,de GER,GK,27,29.4,0,0,0,0,0,0,3,0.0,3,1,0,0.0,1,0,0,0,0,0,0,0,0,2,1,Matches,Arsenal
Granit Xhaka,ch SUI,MF,26,28.7,46,27,27,15,4,18,55,32.7,37,433,126,29.1,157,232,44,55,17,1,38,21,67,85,0,Matches,Arsenal
Nicolas Pépé,ci CIV,FW,24,22.3,30,19,14,13,3,11,23,47.8,12,354,89,25.1,94,156,104,20,2,0,18,7,37,3,0,Matches,Arsenal
Alexandre Lacazette,fr FRA,FW,28,20.8,23,19,6,12,5,4,17,23.5,13,464,114,24.6,55,220,189,13,0,0,13,7,30,14,0,Matches,Arsenal
Bukayo Saka,eng ENG,"DF,FW",17,19.5,38,22,20,11,7,13,33,39.4,20,288,84,29.2,105,106,77,25,4,0,21,12,50,21,1,Matches,Arsenal
Mattéo Guendouzi,fr FRA,MF,20,19.4,24,13,11,9,4,10,36,27.8,26,384,109,28.4,158,175,51,40,7,0,33,30,54,48,0,Matches,Arsenal
Sead Kolašinac,ba BIH,DF,26,18.9,35,18,22,6,7,12,25,48.0,13,230,67,29.1,116,81,33,23,5,0,18,24,59,45,1,Matches,Arsenal
Sokratis Papastathopoulos,gr GRE,DF,31,18.8,23,13,17,5,1,11,25,44.0,14,181,51,28.2,121,55,5,41,22,0,19,14,37,108,0,Matches,Arsenal
Dani Ceballos,es ESP,MF,22,18.8,49,28,25,17,7,17,62,27.4,45,445,120,27.0,197,191,57,29,4,0,25,30,79,22,1,Matches,Arsenal
Mesut Özil,de GER,MF,30,16.0,13,10,9,4,0,2,19,10.5,17,305,63,20.7,67,178,60,9,0,0,9,5,18,3,0,Matches,Arsenal
Lucas Torreira,uy URU,MF,23,16.8,37,24,17,16,4,12,34,35.3,22,403,102,25.3,156,200,47,29,9,0,20,31,68,30,1,Matches,Arsenal
Ainsley Maitland-Niles,eng ENG,DF,21,15.4,41,27,30,9,2,14,42,33.3,28,297,84,28.3,179,86,32,29,5,0,24,29,70,41,0,Matches,Arsenal
Shkodran Mustafi,de GER,DF,27,13.4,14,9,9,4,1,2,13,15.4,11,108,36,33.3,52,50,6,15,7,0,8,18,32,111,2,Matches,Arsenal
Héctor Bellerín,es ESP,DF,24,12.9,23,16,12,7,4,9,31,29.0,22,183,46,25.1,71,87,25,28,4,0,24,18,41,34,0,Matches,Arsenal
Calum Chambers,eng ENG,DF,24,12.2,25,18,14,8,3,9,12,75.0,3,143,51,35.7,77,41,25,21,7,0,14,15,40,61,0,Matches,Arsenal
Kieran Tierney,sco SCO,DF,22,11.0,21,11,12,5,4,10,15,66.7,5,126,39,31.0,62,51,13,22,4,0,18,9,30,44,0,Matches,Arsenal
Joe Willock,eng ENG,"MF,FW",19,9.5,22,15,6,10,6,4,20,20.0,16,242,67,27.7,76,128,38,19,5,1,14,3,25,12,0,Matches,Arsenal
Emiliano Martínez,ar ARG,GK,26,8.6,0,0,0,0,0,0,0,,0,1,0,0.0,1,0,0,0,0,0,0,0,0,0,2,Matches,Arsenal
Eddie Nketiah,eng ENG,FW,20,7.0,10,7,4,5,1,2,7,28.6,5,163,39,23.9,11,78,74,5,0,0,5,1,11,4,0,Matches,Arsenal
Reiss Nelson,eng ENG,FW,19,7.0,12,6,8,3,1,8,14,57.1,6,164,31,18.9,52,69,43,13,1,0,12,3,15,2,0,Matches,Arsenal
Martinelli,br BRA,FW,18,7.4,23,13,12,9,2,6,17,35.3,11,247,69,27.9,88,101,58,20,1,0,19,3,26,7,0,Matches,Arsenal
Rob Holding,eng ENG,DF,23,6.5,6,3,5,1,0,2,3,66.7,1,47,14,29.8,32,10,5,19,6,0,13,5,11,45,2,Matches,Arsenal
Nacho Monreal,es ESP,DF,33,3.0,4,4,3,1,0,1,3,33.3,2,34,10,29.4,19,13,2,3,1,0,2,3,7,17,0,Matches,Arsenal
Cédric Soares,pt POR,DF,27,2.8,6,5,2,4,0,2,5,40.0,3,55,15,27.3,23,26,6,10,0,0,10,3,9,2,0,Matches,Arsenal
Pablo Marí,es ESP,DF,25,1.3,3,1,2,1,0,1,2,50.0,1,11,3,27.3,6,4,1,1,0,0,1,1,4,14,0,Matches,Arsenal
Henrikh Mkhitaryan,am ARM,FW,30,1.2,0,0,0,0,0,0,3,0.0,3,32,8,25.0,4,16,12,2,0,0,2,0,0,1,0,Matches,Arsenal
Emile Smith-Rowe,eng ENG,MF,19,1.1,1,1,1,0,0,1,3,33.3,2,22,7,31.8,6,10,6,1,0,0,1,1,2,3,0,Matches,Arsenal
Jack Grealish,eng ENG,"FW,MF",23,35.9,36,28,13,14,9,8,31,25.8,23,574,154,26.8,161,231,182,55,12,0,43,25,61,13,1,Matches,Aston Villa
Tyrone Mings,eng ENG,DF,26,32.2,25,17,18,6,1,10,18,55.6,8,160,66,41.3,106,43,11,72,55,2,17,33,58,223,7,Matches,Aston Villa
Douglas Luiz,br BRA,MF,21,29.0,52,33,34,14,4,19,66,28.8,47,592,155,26.2,263,263,66,64,18,1,46,36,88,44,2,Matches,Aston Villa
John McGinn,sco SCO,MF,24,25.7,59,41,24,22,13,20,66,30.3,46,508,144,28.3,137,254,117,32,2,0,30,25,84,20,1,Matches,Aston Villa
Matt Targett,eng ENG,DF,23,25.5,57,33,38,16,3,20,56,35.7,36,372,109,29.3,184,145,43,68,9,0,59,60,117,88,1,Matches,Aston Villa
Anwar El Ghazi,nl NED,"FW,MF",24,22.8,17,10,10,5,2,5,24,20.8,19,350,74,21.1,70,163,117,18,1,0,17,12,29,12,0,Matches,Aston Villa
Ezri Konsa,eng ENG,DF,21,22.7,27,18,20,7,0,6,16,37.5,10,193,63,32.6,107,65,21,55,23,0,32,21,48,83,3,Matches,Aston Villa
Frederic Guilbert,fr FRA,DF,24,22.7,82,38,50,22,10,34,74,45.9,40,416,115,27.6,228,133,55,65,13,0,52,48,130,87,1,Matches,Aston Villa
Wesley Moraes,br BRA,FW,22,19.8,14,10,2,6,6,0,5,0.0,5,313,78,24.9,17,145,151,18,6,0,12,4,18,26,0,Matches,Aston Villa
Trézéguet,eg EGY,"FW,MF",24,21.7,42,28,20,14,8,7,42,16.7,35,530,129,24.3,163,231,136,41,2,0,39,26,68,17,0,Matches,Aston Villa
Tom Heaton,eng ENG,GK,33,19.9,0,0,0,0,0,0,2,0.0,2,3,0,0.0,3,0,0,0,0,0,0,0,0,1,0,Matches,Aston Villa
Marvelous Nakamba,zw ZIM,MF,25,20.4,65,47,32,29,4,15,68,22.1,53,491,168,34.2,212,240,39,61,11,0,50,38,103,34,1,Matches,Aston Villa
Conor Hourihane,ie IRL,MF,28,17.0,21,14,5,12,4,8,24,33.3,16,224,38,17.0,68,103,53,27,6,0,21,12,33,24,0,Matches,Aston Villa
Kortney Hause,eng ENG,DF,24,17.2,27,22,23,2,2,11,22,50.0,11,182,73,40.1,112,59,11,46,22,1,24,20,47,114,5,Matches,Aston Villa
Björn Engels,be BEL,DF,24,16.1,9,4,7,2,0,5,11,45.5,6,81,29,35.8,54,26,1,26,19,0,7,29,38,111,2,Matches,Aston Villa
Pepe Reina,es ESP,GK,36,12.0,0,0,0,0,0,0,1,0.0,1,4,1,25.0,4,0,0,0,0,0,0,0,0,1,2,Matches,Aston Villa
Neil Taylor,wal WAL,DF,30,12.1,19,9,14,5,0,9,21,42.9,12,121,33,27.3,61,53,7,38,5,0,33,20,39,32,0,Matches,Aston Villa
Ahmed Elmohamady,eg EGY,DF,31,11.5,25,17,17,6,2,10,22,45.5,12,109,28,25.7,56,40,13,11,5,0,6,13,38,29,0,Matches,Aston Villa
Mbwana Samatta,tz TAN,FW,26,10.5,9,7,1,6,2,1,9,11.1,8,173,45,26.0,7,84,82,8,1,0,7,1,10,6,0,Matches,Aston Villa
Ørjan Nyland,no NOR,GK,28,6.0,0,0,0,0,0,0,0,,0,0,0,,0,0,0,0,0,0,0,0,0,1,1,Matches,Aston Villa
Keinan Davis,eng ENG,FW,21,6.1,2,2,0,2,0,0,3,0.0,3,88,19,21.6,3,50,35,5,1,0,4,0,2,3,0,Matches,Aston Villa
Jota,es ESP,"FW,MF",28,3.7,3,2,1,1,1,2,9,22.2,7,119,17,14.3,43,52,24,3,0,0,3,3,6,6,0,Matches,Aston Villa
Danny Drinkwater,eng ENG,MF,29,2.9,9,5,6,2,1,1,13,7.7,12,106,22,20.8,36,58,12,3,0,0,3,5,14,4,1,Matches,Aston Villa
Henri Lansbury,eng ENG,MF,28,2.2,5,2,3,1,1,0,4,0.0,4,61,18,29.5,24,18,19,6,0,0,6,0,5,1,0,Matches,Aston Villa
Jed Steer,eng ENG,GK,26,0.1,0,0,0,0,0,0,0,,0,0,0,,0,0,0,0,0,0,0,0,0,0,0,Matches,Aston Villa
Jonathan Kodjia,ci CIV,"FW,MF",29,1.3,0,0,0,0,0,0,1,0.0,1,33,9,27.3,6,15,12,2,2,0,0,0,0,2,0,Matches,Aston Villa
Indiana Vassilev,us USA,"FW,MF",18,0.6,1,1,0,1,0,0,1,0.0,1,24,7,29.2,3,7,14,0,0,0,0,0,1,0,0,Matches,Aston Villa
Borja Bastón,es ESP,"MF,FW",26,0.2,0,0,0,0,0,0,2,0.0,2,10,1,10.0,0,9,1,1,0,0,1,0,0,1,1,Matches,Aston Villa
Aaron Ramsdale,eng ENG,GK,21,37.0,0,0,0,0,0,0,2,0.0,2,8,1,12.5,8,0,0,1,0,0,1,0,0,0,2,Matches,Bournemouth
Callum Wilson,eng ENG,FW,27,32.3,15,12,2,6,7,1,14,7.1,13,770,206,26.8,53,323,394,18,2,0,16,3,18,15,0,Matches,Bournemouth
Jefferson Lerma,co COL,MF,24,30.0,81,49,28,47,6,29,62,46.8,33,576,173,30.0,205,323,48,50,12,0,38,54,135,69,0,Matches,Bournemouth
Philip Billing,dk DEN,MF,23,28.1,76,46,29,39,8,17,67,25.4,50,692,164,23.7,209,382,101,88,17,0,71,71,147,117,1,Matches,Bournemouth
Nathan Aké,nl NED,DF,24,27.8,25,11,20,5,0,7,24,29.2,17,222,66,29.7,146,66,10,59,30,0,29,33,58,176,1,Matches,Bournemouth
Steve Cook,eng ENG,DF,28,27.0,22,13,15,7,0,9,23,39.1,14,164,55,33.5,111,44,9,47,28,0,19,45,67,222,1,Matches,Bournemouth
Diego Rico,es ESP,DF,26,25.9,65,42,41,21,3,18,56,32.1,38,406,126,31.0,209,138,59,82,6,0,76,80,145,99,0,Matches,Bournemouth
Adam Smith,eng ENG,DF,28,22.8,52,30,32,15,5,24,54,44.4,30,406,111,27.3,182,155,69,56,6,1,50,25,77,53,0,Matches,Bournemouth
Joshua King,no NOR,"FW,MF",27,22.3,19,15,8,7,4,2,15,13.3,13,496,123,24.8,80,219,197,27,4,0,23,5,24,11,0,Matches,Bournemouth
Ryan Fraser,sco SCO,"MF,FW",25,23.0,9,8,3,3,3,4,17,23.5,13,298,65,21.8,79,122,97,28,3,2,25,16,25,18,0,Matches,Bournemouth
Harry Wilson,wal WAL,"MF,FW",22,18.3,25,11,7,12,6,13,36,36.1,23,411,96,23.4,135,193,83,38,3,0,35,12,37,21,0,Matches,Bournemouth
Dominic Solanke,eng ENG,"FW,MF",21,18.3,11,10,2,9,0,3,27,11.1,24,643,151,23.5,84,319,240,19,5,0,14,8,19,21,0,Matches,Bournemouth
Jack Stacey,eng ENG,DF,23,17.2,21,13,13,5,3,5,21,23.8,16,241,62,25.7,116,80,45,41,9,0,32,21,42,53,1,Matches,Bournemouth
Lewis Cook,eng ENG,MF,22,15.0,27,16,15,10,2,8,40,20.0,32,375,71,18.9,125,197,53,20,6,0,14,21,48,15,0,Matches,Bournemouth
Dan Gosling,eng ENG,MF,29,14.0,28,20,16,8,4,7,30,23.3,23,357,93,26.1,133,149,75,38,11,0,27,20,48,27,0,Matches,Bournemouth
Simon Francis,eng ENG,DF,34,10.8,17,12,13,4,0,11,25,44.0,14,107,29,27.1,71,24,12,29,14,0,15,20,37,91,2,Matches,Bournemouth
Chris Mepham,wal WAL,DF,21,10.1,23,14,14,9,0,9,16,56.3,7,132,49,37.1,83,42,7,20,12,0,8,17,40,75,1,Matches,Bournemouth
David Brooks,wal WAL,MF,22,5.6,4,3,1,1,2,0,15,0.0,15,102,20,19.6,28,48,26,7,1,0,6,3,7,3,0,Matches,Bournemouth
Junior Stanislas,eng ENG,"MF,DF",29,7.9,10,6,2,2,6,4,9,44.4,5,107,34,31.8,32,41,34,9,0,0,9,5,15,2,0,Matches,Bournemouth
Lloyd Kelly,eng ENG,DF,20,7.1,9,6,5,4,0,5,9,55.6,4,73,29,39.7,39,27,7,11,6,0,5,6,15,17,1,Matches,Bournemouth
Arnaut Groeneveld,nl NED,MF,22,7.0,6,5,3,2,1,2,7,28.6,5,78,32,41.0,28,27,23,3,0,0,3,8,14,8,1,Matches,Bournemouth
Andrew Surman,eng ENG,MF,32,2.6,5,2,2,3,0,3,4,75.0,1,45,11,24.4,19,20,6,4,0,0,4,1,6,6,0,Matches,Bournemouth
Charlie Daniels,eng ENG,DF,32,1.4,1,0,0,1,0,1,2,50.0,1,26,5,19.2,20,6,0,5,1,0,4,1,2,4,1,Matches,Bournemouth
Jack Simpson,eng ENG,DF,22,2.7,5,2,5,0,0,2,6,33.3,4,32,4,12.5,17,13,2,2,0,0,2,2,7,13,1,Matches,Bournemouth
Mark Travers,ie IRL,GK,20,1.0,0,0,0,0,0,0,0,,0,0,0,,0,0,0,0,0,0,0,0,0,0,1,Matches,Bournemouth
Jordon Ibe,eng ENG,DF,23,0.6,3,3,3,0,0,0,0,,0,11,3,27.3,5,5,1,0,0,0,0,0,3,0,0,Matches,Bournemouth
Sam Surridge,eng ENG,FW,21,0.3,0,0,0,0,0,0,0,,0,17,3,17.6,0,8,9,1,0,0,1,1,1,0,0,Matches,Bournemouth
Mathew Ryan,au AUS,GK,27,38.0,0,0,0,0,0,0,5,0.0,5,10,4,40.0,10,0,0,0,0,0,0,2,2,2,4,Matches,Brighton
Lewis Dunk,eng ENG,DF,27,35.9,43,28,31,12,0,13,41,31.7,28,248,107,43.1,164,72,12,71,37,3,34,54,97,162,1,Matches,Brighton
Dan Burn,eng ENG,DF,27,32.0,63,36,34,23,6,24,56,42.9,32,465,164,35.3,251,161,53,67,22,0,45,37,100,148,0,Matches,Brighton
Davy Pröpper,nl NED,MF,27,31.4,58,38,29,23,6,22,68,32.4,46,484,144,29.8,195,235,54,39,11,0,28,30,88,43,2,Matches,Brighton
Adam Webster,eng ENG,DF,24,29.6,37,25,25,10,2,16,36,44.4,20,222,86,38.7,146,67,9,66,31,0,35,43,80,182,3,Matches,Brighton
Neal Maupay,fr FRA,FW,22,30.7,28,17,8,13,7,8,36,22.2,28,703,185,26.3,70,278,355,31,4,0,27,5,33,7,0,Matches,Brighton
Dale Stephens,eng ENG,MF,30,28.1,76,40,32,35,9,21,71,29.6,50,465,150,32.3,206,224,35,43,13,1,30,58,134,46,3,Matches,Brighton
Aaron Mooy,au AUS,"MF,FW",28,23.2,43,31,13,19,11,8,45,17.8,37,421,125,29.7,111,198,112,48,7,1,41,23,66,29,0,Matches,Brighton
Martín Montoya,es ESP,DF,28,21.1,49,28,30,14,5,22,50,44.0,28,375,92,24.5,163,159,53,41,6,0,35,29,78,55,1,Matches,Brighton
Leandro Trossard,be BEL,"FW,MF",24,22.3,28,16,13,12,3,9,39,23.1,30,373,100,26.8,72,169,132,29,2,0,27,8,36,5,0,Matches,Brighton
Pascal Groß,de GER,"FW,MF",28,20.0,33,21,6,19,8,8,32,25.0,24,395,103,26.1,81,195,119,27,2,0,25,9,42,11,0,Matches,Brighton
Yves Bissouma,ml MLI,MF,22,14.0,58,36,35,20,3,18,38,47.4,20,308,90,29.2,126,143,39,28,4,0,24,22,80,22,0,Matches,Brighton
Aaron Connolly,ie IRL,FW,19,14.0,12,8,1,5,6,3,12,25.0,9,234,69,29.5,14,94,126,8,1,0,7,0,12,1,0,Matches,Brighton
Shane Duffy,ie IRL,DF,27,13.8,16,9,10,5,1,4,18,22.2,14,100,34,34.0,71,27,2,21,8,0,13,21,37,116,0,Matches,Brighton
Steven Alzate,co COL,"MF,DF",20,13.2,28,23,23,3,2,10,22,45.5,12,235,77,32.8,99,94,42,26,3,0,23,13,41,14,0,Matches,Brighton
Solly March,eng ENG,"DF,FW",25,12.7,26,17,16,8,2,9,21,42.9,12,158,44,27.8,54,57,47,22,3,0,19,21,47,19,1,Matches,Brighton
Glenn Murray,eng ENG,FW,35,8.9,3,2,0,2,1,0,6,0.0,6,144,35,24.3,10,74,60,6,1,0,5,1,4,9,0,Matches,Brighton
Bernardo,br BRA,DF,24,7.5,28,16,14,5,9,12,19,63.2,7,129,44,34.1,56,48,25,16,3,0,13,7,35,25,0,Matches,Brighton
Tariq Lamptey,eng ENG,DF,18,6.5,9,3,8,1,0,0,9,0.0,9,91,17,18.7,39,32,20,13,1,0,12,18,27,15,1,Matches,Brighton
Ezequiel Schelotto,it ITA,DF,30,4.0,6,5,4,1,1,0,5,0.0,5,47,14,29.8,26,14,7,7,0,0,7,7,13,17,0,Matches,Brighton
Alexis Mac Allister,ar ARG,"MF,FW",20,3.9,9,4,4,3,2,4,9,44.4,5,105,25,23.8,27,51,27,14,1,0,13,1,10,1,0,Matches,Brighton
Alireza Jahanbakhsh,ir IRN,"FW,MF",25,3.5,7,3,2,2,3,3,6,50.0,3,51,20,39.2,15,16,20,5,0,0,5,1,8,4,0,Matches,Brighton
Jürgen Locadia,nl NED,"MF,FW",25,1.0,1,1,0,1,0,0,0,,0,12,6,50.0,0,6,6,0,0,0,0,0,1,0,0,Matches,Brighton
Florin Andone,ro ROU,"MF,FW",26,0.8,2,2,0,1,1,0,0,,0,7,1,14.3,1,3,3,1,1,0,0,0,2,1,0,Matches,Brighton
Gaëtan Bong,cm CMR,"MF,DF",31,0.7,0,0,0,0,0,0,0,,0,12,7,58.3,6,4,2,2,1,0,1,0,0,0,0,Matches,Brighton
Nick Pope,eng ENG,GK,27,38.0,0,0,0,0,0,0,1,0.0,1,5,1,20.0,5,0,0,1,0,0,1,2,2,0,1,Matches,Burnley
James Tarkowski,eng ENG,DF,26,38.0,76,51,54,22,0,25,50,50.0,25,313,100,31.9,217,84,12,85,46,0,39,61,137,329,1,Matches,Burnley
Dwight McNeil,eng ENG,MF,19,37.1,55,28,20,22,13,17,68,25.0,51,734,178,24.3,208,334,192,71,6,1,65,28,83,34,0,Matches,Burnley
Ashley Westwood,eng ENG,MF,29,35.0,48,30,18,22,8,17,59,28.8,42,609,152,25.0,204,309,96,45,9,0,36,32,80,32,1,Matches,Burnley
Ben Mee,eng ENG,DF,29,32.0,35,16,23,12,0,19,36,52.8,17,176,56,31.8,108,62,6,64,34,0,30,44,79,279,0,Matches,Burnley
Jack Cork,eng ENG,MF,30,29.0,39,27,10,21,8,11,65,16.9,54,605,172,28.4,146,347,112,53,12,0,41,29,68,57,0,Matches,Burnley
Chris Wood,nz NZL,FW,27,27.1,9,6,1,3,5,4,18,22.2,14,408,92,22.5,23,151,234,18,4,0,14,4,13,17,0,Matches,Burnley
Charlie Taylor,eng ENG,DF,25,21.6,43,16,26,14,3,17,43,39.5,26,224,65,29.0,117,79,28,60,7,0,53,29,72,106,1,Matches,Burnley
Jeff Hendrick,ie IRL,MF,27,21.5,18,10,7,7,4,2,30,6.7,28,356,69,19.4,83,175,98,35,7,0,28,19,37,19,0,Matches,Burnley
Phil Bardsley,sco SCO,DF,34,21.0,55,33,21,25,9,18,33,54.5,15,234,65,27.8,101,111,22,43,12,1,31,29,84,88,0,Matches,Burnley
Erik Pieters,nl NED,"DF,MF",30,20.9,58,41,23,32,3,22,62,35.5,40,345,85,24.6,162,141,42,65,8,0,57,27,85,89,0,Matches,Burnley
Jay Rodriguez,eng ENG,FW,30,22.4,33,17,7,16,10,6,36,16.7,30,574,150,26.1,77,244,253,43,11,0,32,5,38,7,0,Matches,Burnley
Matthew Lowton,eng ENG,DF,30,17.0,44,24,20,21,3,24,43,55.8,19,202,60,29.7,99,74,29,42,9,1,33,26,70,79,1,Matches,Burnley
Ashley Barnes,at AUT,FW,29,15.0,6,4,1,3,2,2,13,15.4,11,275,63,22.9,20,121,134,17,4,0,13,6,12,14,0,Matches,Burnley
Josh Brownhill,eng ENG,MF,23,8.9,15,8,6,7,2,1,7,14.3,6,111,31,27.9,36,54,21,10,3,0,7,13,28,16,0,Matches,Burnley
Matěj Vydra,cz CZE,FW,27,9.1,4,2,1,2,1,2,6,33.3,4,184,47,25.5,15,66,103,12,3,0,9,1,5,7,0,Matches,Burnley
Jóhann Berg Guðmundsson,is ISL,MF,28,6.9,7,3,2,1,4,2,9,22.2,7,105,19,18.1,34,35,36,10,1,0,9,7,14,8,0,Matches,Burnley
Kevin Long,ie IRL,DF,28,6.3,10,8,8,2,0,3,8,37.5,5,54,17,31.5,35,17,2,15,9,0,6,4,14,39,0,Matches,Burnley
Robbie Brady,ie IRL,MF,27,5.0,10,5,7,3,0,2,9,22.2,7,126,28,22.2,46,53,27,14,2,0,12,5,15,8,0,Matches,Burnley
Aaron Lennon,eng ENG,MF,32,5.5,15,9,7,4,4,9,14,64.3,5,143,27,18.9,37,67,39,8,2,0,6,7,22,6,0,Matches,Burnley
Danny Drinkwater,eng ENG,MF,29,0.6,2,2,1,1,0,0,1,0.0,1,23,5,21.7,10,10,3,1,0,0,1,1,3,0,0,Matches,Burnley
Max Thompson,eng ENG,FW,17,0.0,0,0,0,0,0,0,0,,0,0,0,,0,0,0,0,0,0,0,0,0,0,0,Matches,Burnley
César Azpilicueta,es ESP,DF,29,35.9,102,61,50,38,14,37,74,50.0,37,568,186,32.7,250,221,97,81,20,0,61,66,168,146,0,Matches,Chelsea
Kepa Arrizabalaga,es ESP,GK,24,33.0,0,0,0,0,0,0,2,0.0,2,3,1,33.3,3,0,0,0,0,0,0,1,1,1,2,Matches,Chelsea
Mason Mount,eng ENG,"MF,FW",20,31.9,48,31,14,21,13,13,47,27.7,34,729,204,28.0,121,339,269,26,1,0,25,15,63,16,0,Matches,Chelsea
Willian,br BRA,FW,30,28.9,43,27,13,22,8,11,51,21.6,40,527,150,28.5,98,261,168,22,1,0,21,20,63,11,0,Matches,Chelsea
Jorginho,it ITA,MF,27,26.4,69,44,22,35,12,27,85,31.8,58,556,162,29.1,187,298,71,41,5,1,36,64,133,34,0,Matches,Chelsea
Kurt Zouma,fr FRA,DF,24,26.0,33,17,25,8,0,3,8,37.5,5,177,55,31.1,102,72,3,34,16,0,18,55,88,181,3,Matches,Chelsea
Tammy Abraham,eng ENG,FW,21,24.6,14,10,4,5,5,4,16,25.0,12,430,130,30.2,19,169,242,23,5,0,18,5,19,26,0,Matches,Chelsea
Mateo Kovačić,hr CRO,MF,25,23.0,80,55,31,42,7,30,78,38.5,48,533,173,32.5,152,281,100,28,2,0,26,20,100,17,0,Matches,Chelsea
Andreas Christensen,dk DEN,DF,23,19.5,41,20,25,13,3,11,24,45.8,13,156,57,36.5,90,62,4,22,9,0,13,31,72,104,0,Matches,Chelsea
N'Golo Kanté,fr FRA,MF,28,19.2,58,43,29,22,7,12,33,36.4,21,438,141,32.2,153,190,95,43,3,0,40,46,104,35,0,Matches,Chelsea
Christian Pulisic,us USA,FW,20,19.1,31,19,17,10,4,11,35,31.4,24,380,112,29.5,91,171,118,23,0,0,23,7,38,11,0,Matches,Chelsea
Antonio Rüdiger,de GER,DF,26,19.0,43,24,28,13,2,13,21,61.9,8,166,64,38.6,99,64,3,27,8,0,19,13,56,108,2,Matches,Chelsea
Reece James,eng ENG,DF,19,16.8,42,23,20,17,5,14,31,45.2,17,271,73,26.9,124,113,34,46,8,0,38,23,65,39,0,Matches,Chelsea
Marcos Alonso,es ESP,DF,28,15.9,27,19,17,6,4,5,28,17.9,23,215,88,40.9,89,84,42,30,1,0,29,20,47,48,0,Matches,Chelsea
Fikayo Tomori,eng ENG,DF,21,14.3,30,15,19,10,1,7,13,53.8,6,149,48,32.2,82,64,3,29,9,0,20,20,50,93,2,Matches,Chelsea
Ross Barkley,eng ENG,MF,25,12.3,16,11,6,8,2,4,17,23.5,13,171,50,29.2,17,96,58,11,3,1,8,8,24,12,0,Matches,Chelsea
Emerson Palmieri,it ITA,DF,24,11.4,22,7,9,10,3,6,13,46.2,7,126,44,34.9,37,60,29,31,2,0,29,17,39,22,0,Matches,Chelsea
Olivier Giroud,fr FRA,FW,32,11.0,4,3,1,3,0,0,10,0.0,10,203,58,28.6,10,98,95,20,6,0,14,2,6,13,0,Matches,Chelsea
Pedro,es ESP,FW,32,7.3,17,10,7,7,3,3,18,16.7,15,152,49,32.2,34,72,46,7,0,0,7,9,26,1,0,Matches,Chelsea
Callum Hudson-Odoi,eng ENG,FW,18,9.6,8,5,5,2,1,1,10,10.0,9,121,29,24.0,22,59,40,18,0,0,18,2,10,6,0,Matches,Chelsea
Willy Caballero,ar ARG,GK,37,5.0,0,0,0,0,0,0,0,,0,0,0,,0,0,0,0,0,0,0,0,0,1,0,Matches,Chelsea
Ruben Loftus-Cheek,eng ENG,"MF,FW",23,2.3,0,0,0,0,0,0,1,0.0,1,21,10,47.6,8,4,9,3,1,0,2,1,1,3,0,Matches,Chelsea
Billy Gilmour,sco SCO,MF,18,2.2,6,4,4,2,0,3,6,50.0,3,36,14,38.9,15,20,1,6,0,0,6,3,9,1,0,Matches,Chelsea
Michy Batshuayi,be BEL,FW,25,2.7,2,1,2,0,0,0,2,0.0,2,72,17,23.6,5,34,33,4,2,0,2,0,2,1,0,Matches,Chelsea
Tariq Lamptey,eng ENG,DF,18,0.4,2,0,1,1,0,2,2,100.0,0,3,3,100.0,1,1,1,0,0,0,0,0,2,0,0,Matches,Chelsea
Faustino Anjorin,eng ENG,FW,17,0.2,1,0,1,0,0,0,0,,0,2,1,50.0,0,2,0,1,0,0,1,0,1,0,0,Matches,Chelsea
Armando Broja,al ALB,FW,17,0.1,0,0,0,0,0,0,0,,0,3,0,0.0,0,2,1,0,0,0,0,0,0,0,0,Matches,Chelsea
Wilfried Zaha,ci CIV,"MF,FW",26,36.4,45,31,16,15,14,10,45,22.2,35,813,237,29.2,230,343,240,33,2,0,31,16,61,4,0,Matches,Crystal Palace
Jordan Ayew,gh GHA,"FW,MF",27,35.0,54,29,16,21,17,15,45,33.3,30,1018,219,21.5,178,515,325,35,6,0,29,13,67,20,0,Matches,Crystal Palace
James McArthur,sco SCO,MF,31,34.3,110,70,50,46,14,36,106,34.0,70,932,263,28.2,368,438,126,97,24,1,73,61,171,57,0,Matches,Crystal Palace
Vicente Guaita,es ESP,GK,32,35.0,0,0,0,0,0,0,2,0.0,2,3,1,33.3,3,0,0,0,0,0,0,0,0,0,2,Matches,Crystal Palace
Cheikhou Kouyaté,sn SEN,"MF,DF",29,28.1,70,45,45,23,2,23,50,46.0,27,418,123,29.4,190,178,50,60,13,0,47,38,108,79,1,Matches,Crystal Palace
Patrick van Aanholt,nl NED,DF,28,27.9,51,32,33,16,2,22,54,40.7,32,267,74,27.7,159,71,37,57,13,1,44,46,97,67,3,Matches,Crystal Palace
Luka Milivojević,rs SRB,MF,28,27.9,60,37,34,24,2,28,76,36.8,48,519,135,26.0,249,229,41,47,8,0,39,39,99,66,1,Matches,Crystal Palace
Joel Ward,eng ENG,DF,29,26.5,67,31,44,18,5,28,54,51.9,26,318,84,26.4,198,87,33,46,4,1,42,52,119,106,1,Matches,Crystal Palace
Gary Cahill,eng ENG,DF,33,24.1,18,12,13,5,0,6,15,40.0,9,106,35,33.0,75,23,8,45,24,0,21,18,36,134,0,Matches,Crystal Palace
James Tomkins,eng ENG,DF,30,17.6,30,14,23,7,0,12,18,66.7,6,138,45,32.6,98,35,5,33,15,0,18,23,53,138,0,Matches,Crystal Palace
Martin Kelly,eng ENG,DF,29,17.2,24,18,18,6,0,12,29,41.4,17,181,63,34.8,129,42,10,50,15,0,35,15,39,102,3,Matches,Crystal Palace
James McCarthy,ie IRL,MF,28,18.7,77,42,33,37,7,30,69,43.5,39,419,125,29.8,163,208,48,35,5,0,30,27,104,19,1,Matches,Crystal Palace
Andros Townsend,eng ENG,MF,28,14.4,32,20,14,13,5,14,36,38.9,22,290,65,22.4,104,126,60,28,0,0,28,16,48,10,0,Matches,Crystal Palace
Scott Dann,eng ENG,DF,32,14.1,12,5,10,2,0,7,14,50.0,7,41,16,39.0,29,12,0,17,6,0,11,14,26,80,0,Matches,Crystal Palace
Christian Benteke,be BEL,FW,28,14.0,9,5,0,6,3,1,8,12.5,7,178,49,27.5,4,70,104,14,6,0,8,4,13,25,0,Matches,Crystal Palace
Jeffrey Schlupp,gh GHA,"MF,DF",26,11.5,20,6,12,8,0,3,13,23.1,10,149,36,24.2,55,71,23,25,3,0,22,13,33,15,0,Matches,Crystal Palace
Mamadou Sakho,fr FRA,DF,29,10.3,12,7,10,1,1,0,5,0.0,5,53,15,28.3,34,19,0,15,5,0,10,22,34,53,1,Matches,Crystal Palace
Jaïro Riedewald,nl NED,"DF,MF",22,8.5,15,12,5,8,2,8,13,61.5,5,118,40,33.9,50,52,16,13,2,0,11,15,30,17,0,Matches,Crystal Palace
Max Meyer,de GER,"MF,FW",23,7.3,17,8,9,8,0,4,17,23.5,13,144,39,27.1,64,63,17,13,1,0,12,9,26,3,0,Matches,Crystal Palace
Wayne Hennessey,wal WAL,GK,32,3.0,0,0,0,0,0,0,0,,0,0,0,,0,0,0,0,0,0,0,1,1,0,0,Matches,Crystal Palace
Tyrick Mitchell,eng ENG,DF,19,2.2,6,2,4,0,2,1,9,11.1,8,48,13,27.1,24,15,9,6,0,0,6,3,9,1,0,Matches,Crystal Palace
Cenk Tosun,tr TUR,FW,28,2.0,2,2,2,0,0,0,0,,0,70,11,15.7,16,41,13,3,0,0,3,0,2,1,0,Matches,Crystal Palace
Connor Wickham,eng ENG,"FW,MF",26,1.1,2,2,1,1,0,0,0,,0,28,10,35.7,3,13,12,3,1,0,2,0,2,1,0,Matches,Crystal Palace
Brandon Pierrick,eng ENG,MF,17,0.2,,0,,,,,,,,,,,,,,,,,,1,0,,,Matches,Crystal Palace
Víctor Camarasa,es ESP,MF,25,0.1,0,0,0,0,0,0,0,,0,0,0,,0,0,0,0,0,0,0,0,0,0,0,Matches,Crystal Palace
Jordan Pickford,eng ENG,GK,25,38.0,0,0,0,0,0,0,5,0.0,5,8,3,37.5,8,0,0,0,0,0,0,1,1,1,1,Matches,Everton
Richarlison,br BRA,FW,22,34.1,68,45,26,28,14,19,57,33.3,38,709,188,26.5,120,332,257,34,5,0,29,12,80,48,0,Matches,Everton
Lucas Digne,fr FRA,DF,26,33.7,87,39,58,22,7,30,67,44.8,37,496,133,26.8,249,156,91,69,10,0,59,46,133,145,1,Matches,Everton
Dominic Calvert-Lewin,eng ENG,FW,22,29.2,15,11,1,9,5,3,18,16.7,15,471,130,27.6,11,191,269,22,5,0,17,6,21,34,0,Matches,Everton
Gylfi Sigurðsson,is ISL,MF,29,28.4,60,45,15,31,14,24,88,27.3,64,652,165,25.3,158,348,146,49,5,0,44,36,96,16,1,Matches,Everton
Michael Keane,eng ENG,DF,26,28.4,41,26,26,14,1,15,27,55.6,12,189,65,34.4,124,60,5,52,27,0,25,46,87,208,1,Matches,Everton
Yerry Mina,co COL,DF,24,25.4,43,20,30,11,2,15,27,55.6,12,229,66,28.8,155,60,14,37,18,0,19,29,72,178,1,Matches,Everton
Mason Holgate,eng ENG,DF,22,22.8,50,28,34,15,1,21,37,56.8,16,242,77,31.8,146,83,13,32,16,1,16,32,82,145,1,Matches,Everton
Tom Davies,eng ENG,MF,21,22.5,36,18,13,16,7,8,51,15.7,43,427,99,23.2,158,211,58,34,4,0,30,34,70,35,1,Matches,Everton
Séamus Coleman,ie IRL,DF,30,20.4,50,31,30,17,3,21,35,60.0,14,216,78,36.1,113,81,22,43,10,0,33,24,74,56,1,Matches,Everton
Alex Iwobi,ng NGA,"MF,FW",23,17.7,27,14,11,14,2,10,33,30.3,23,369,96,26.0,99,181,89,20,3,0,17,13,40,13,1,Matches,Everton
Djibril Sidibé,fr FRA,DF,27,20.3,84,40,48,21,15,34,72,47.2,38,392,114,29.1,200,130,62,37,3,0,34,41,125,50,0,Matches,Everton
André Gomes,pt POR,MF,26,16.2,32,24,13,14,5,7,63,11.1,56,367,93,25.3,126,195,46,28,3,0,25,7,39,10,0,Matches,Everton
Theo Walcott,eng ENG,"MF,FW",30,14.3,17,8,10,5,2,5,14,35.7,9,190,46,24.2,53,85,52,18,1,0,17,8,25,5,0,Matches,Everton
Bernard,br BRA,"MF,FW",26,14.2,25,14,9,10,6,6,39,15.4,33,271,69,25.5,64,143,64,30,2,0,28,16,41,8,0,Matches,Everton
Fabian Delph,eng ENG,MF,29,13.2,29,11,11,11,7,11,32,34.4,21,189,55,29.1,76,87,26,22,6,0,16,16,45,19,1,Matches,Everton
Morgan Schneiderlin,fr FRA,MF,29,11.1,32,19,14,16,2,9,34,26.5,25,230,58,25.2,89,122,19,22,3,0,19,21,53,24,0,Matches,Everton
Moise Kean,it ITA,FW,19,9.5,7,6,2,2,3,0,3,0.0,3,119,36,30.3,12,50,57,4,1,0,3,6,13,3,0,Matches,Everton
Anthony Gordon,eng ENG,"MF,FW",18,4.9,8,6,4,4,0,1,14,7.1,13,120,25,20.8,39,61,20,12,2,0,10,8,16,3,0,Matches,Everton
Leighton Baines,eng ENG,DF,34,4.5,10,6,7,2,1,2,7,28.6,5,51,14,27.5,28,10,13,11,2,0,9,5,15,12,0,Matches,Everton
Jarrad Branthwaite,eng ENG,DF,17,3.3,7,7,5,2,0,1,4,25.0,3,33,16,48.5,21,11,1,5,3,0,2,1,8,17,0,Matches,Everton
Cenk Tosun,tr TUR,FW,28,3.2,2,0,0,0,2,0,2,0.0,2,54,16,29.6,1,21,32,2,1,0,1,0,2,1,0,Matches,Everton
Jean-Philippe Gbamin,ci CIV,MF,23,1.5,5,4,2,1,2,1,4,25.0,3,29,13,44.8,13,11,5,2,0,0,2,1,6,6,0,Matches,Everton
Oumar Niasse,sn SEN,FW,29,0.2,4,1,0,2,2,2,2,100.0,0,9,1,11.1,1,5,3,2,0,0,2,1,5,0,0,Matches,Everton
Kasper Schmeichel,dk DEN,GK,32,38.0,0,0,0,0,0,0,1,0.0,1,5,2,40.0,5,0,0,0,0,0,0,0,0,0,1,Matches,Leicester City
Jonny Evans,nir NIR,DF,31,37.6,48,31,31,16,1,27,42,64.3,15,278,111,39.9,178,80,20,53,21,0,32,58,106,271,4,Matches,Leicester City
Çağlar Söyüncü,tr TUR,DF,23,33.7,73,47,49,23,1,29,55,52.7,26,298,119,39.9,188,102,8,49,19,2,30,43,116,222,1,Matches,Leicester City
Jamie Vardy,eng ENG,FW,32,33.7,17,11,1,10,6,1,6,16.7,5,497,146,29.4,5,183,309,29,5,0,24,2,19,23,0,Matches,Leicester City
Youri Tielemans,be BEL,MF,22,31.4,57,40,18,28,11,15,71,21.1,56,608,168,27.6,155,327,126,51,6,0,45,29,86,24,0,Matches,Leicester City
Wilfred Ndidi,ng NGA,MF,22,29.7,125,76,61,52,12,37,105,35.2,68,744,243,32.7,275,396,73,71,5,0,66,84,209,82,1,Matches,Leicester City
James Maddison,eng ENG,MF,22,29.2,56,39,19,23,14,22,69,31.9,47,627,199,31.7,160,338,129,21,1,0,20,10,66,8,1,Matches,Leicester City
Ricardo Pereira,pt POR,DF,25,28.0,122,68,71,35,16,56,121,46.3,65,563,176,31.3,272,189,102,59,8,0,51,43,165,97,2,Matches,Leicester City
Ben Chilwell,eng ENG,DF,22,26.4,51,26,33,14,4,19,59,32.2,40,414,116,28.0,193,159,62,58,9,0,49,28,79,88,0,Matches,Leicester City
Ayoze Pérez,es ESP,"MF,FW",26,22.3,51,34,15,26,10,14,58,24.1,44,575,174,30.3,106,293,176,32,2,0,30,13,64,12,0,Matches,Leicester City
Harvey Barnes,eng ENG,"MF,FW",21,23.1,22,12,10,9,3,7,26,26.9,19,328,86,26.2,69,153,106,23,4,0,19,5,27,7,1,Matches,Leicester City
Dennis Praet,be BEL,MF,25,12.6,30,18,7,19,4,10,31,32.3,21,304,76,25.0,93,162,49,26,2,0,24,15,45,13,1,Matches,Leicester City
Kelechi Iheanacho,ng NGA,FW,22,10.7,6,5,0,4,2,3,10,30.0,7,193,56,29.0,21,89,83,9,1,0,8,4,10,5,0,Matches,Leicester City
James Justin,eng ENG,DF,21,11.2,35,19,21,13,1,13,23,56.5,10,158,57,36.1,75,59,24,25,7,0,18,9,44,30,0,Matches,Leicester City
Hamza Choudhury,eng ENG,MF,21,9.9,20,13,8,10,2,5,28,17.9,23,192,62,32.3,80,88,24,20,7,0,13,27,47,18,0,Matches,Leicester City
Marc Albrighton,eng ENG,"MF,DF",29,9.6,23,11,11,11,1,7,29,24.1,22,192,66,34.4,46,95,51,18,1,0,17,8,31,6,0,Matches,Leicester City
Christian Fuchs,at AUT,DF,33,8.6,15,9,8,7,0,8,23,34.8,15,144,45,31.3,88,51,5,29,3,0,26,16,31,39,1,Matches,Leicester City
Wes Morgan,jm JAM,DF,35,4.8,5,4,3,2,0,1,3,33.3,2,30,16,53.3,16,13,1,6,4,0,2,7,12,30,0,Matches,Leicester City
Nampalys Mendy,fr FRA,MF,27,3.2,7,4,4,2,1,1,2,50.0,1,42,14,33.3,22,18,2,5,1,0,4,6,13,7,0,Matches,Leicester City
Demarai Gray,eng ENG,"MF,FW",23,6.9,8,5,6,1,1,3,14,21.4,11,129,39,30.2,32,63,34,10,0,0,10,5,13,2,0,Matches,Leicester City
Ryan Bennett,eng ENG,DF,29,3.7,5,2,2,3,0,4,6,66.7,2,35,7,20.0,14,19,2,3,1,0,2,7,12,15,0,Matches,Leicester City
Luke Thomas,eng ENG,DF,,3.0,4,3,2,2,0,1,4,25.0,3,36,8,22.2,13,17,6,3,0,0,3,4,8,10,0,Matches,Leicester City
George Hirst,eng ENG,FW,20,0.1,0,0,0,0,0,0,0,,0,3,0,0.0,0,2,1,0,0,0,0,0,0,0,0,Matches,Leicester City
Matty James,eng ENG,MF,28,0.1,0,0,0,0,0,0,0,,0,2,2,100.0,0,1,1,0,0,0,0,0,0,0,0,Matches,Leicester City
Virgil van Dijk,nl NED,DF,28,38.0,30,20,20,9,1,6,15,40.0,9,133,46,34.6,84,37,12,32,16,1,16,35,65,259,2,Matches,Liverpool
Trent Alexander-Arnold,eng ENG,DF,20,35.3,58,25,37,15,6,34,85,40.0,51,409,131,32.0,193,123,93,53,9,0,44,46,104,98,2,Matches,Liverpool
Georginio Wijnaldum,nl NED,MF,28,32.6,37,29,13,17,7,5,34,14.7,29,489,160,32.7,126,255,108,35,4,0,31,18,55,34,1,Matches,Liverpool
Andrew Robertson,sco SCO,DF,25,34.6,60,32,19,25,16,31,69,44.9,38,390,134,34.4,136,144,110,59,7,0,52,38,98,82,0,Matches,Liverpool
Roberto Firmino,br BRA,FW,27,33.2,37,26,7,17,13,10,34,29.4,24,694,216,31.1,57,307,330,47,5,0,42,8,45,16,0,Matches,Liverpool
Mohamed Salah,eg EGY,FW,27,32.0,21,13,3,5,13,4,27,14.8,23,552,180,32.6,48,161,343,13,3,0,10,8,29,2,0,Matches,Liverpool
Sadio Mané,sn SEN,FW,27,30.5,50,35,13,23,14,15,46,32.6,31,504,153,30.4,106,167,231,30,1,0,29,14,64,5,0,Matches,Liverpool
Alisson,br BRA,GK,26,28.3,0,0,0,0,0,0,3,0.0,3,5,1,20.0,5,0,0,0,0,0,0,1,1,2,1,Matches,Liverpool
Jordan Henderson,eng ENG,MF,29,24.9,65,36,22,31,12,23,63,36.5,40,532,169,31.8,134,287,111,37,5,0,32,29,94,27,0,Matches,Liverpool
Fabinho,br BRA,MF,25,23.1,77,53,27,37,13,26,65,40.0,39,428,139,32.5,149,219,60,36,2,0,34,35,112,34,0,Matches,Liverpool
Joe Gomez,eng ENG,DF,22,22.3,26,15,17,9,0,10,22,45.5,12,151,60,39.7,92,55,4,25,8,0,17,41,67,90,1,Matches,Liverpool
Alex Oxlade-Chamberlain,eng ENG,"MF,FW",25,16.5,23,14,4,12,7,5,25,20.0,20,374,111,29.7,79,171,124,27,2,0,25,22,45,7,0,Matches,Liverpool
James Milner,eng ENG,"MF,DF",33,10.4,17,10,3,12,2,4,22,18.2,18,169,41,24.3,50,93,26,15,3,1,12,8,25,25,0,Matches,Liverpool
Adrián,es ESP,GK,32,9.7,0,0,0,0,0,0,1,0.0,1,2,0,0.0,2,0,0,0,0,0,0,0,0,0,2,Matches,Liverpool
Naby Keïta,gn GUI,MF,24,9.1,27,20,8,13,6,9,25,36.0,16,213,78,36.6,41,99,73,19,0,0,19,11,38,4,0,Matches,Liverpool
Dejan Lovren,hr CRO,DF,30,8.6,16,9,12,4,0,7,13,53.8,6,80,22,27.5,56,22,2,13,6,0,7,11,27,81,1,Matches,Liverpool
Joël Matip,cm CMR,DF,27,7.8,13,9,5,6,2,5,12,41.7,7,64,27,42.2,35,27,2,7,3,0,4,13,26,76,0,Matches,Liverpool
Divock Origi,be BEL,FW,24,8.0,15,10,2,7,6,4,7,57.1,3,152,53,34.9,15,61,76,6,0,0,6,4,19,7,0,Matches,Liverpool
Adam Lallana,eng ENG,"MF,FW",31,4.2,20,12,9,9,2,9,27,33.3,18,132,41,31.1,45,54,33,13,0,0,13,4,24,3,0,Matches,Liverpool
Neco Williams,wal WAL,DF,18,2.6,6,2,1,3,2,3,4,75.0,1,36,12,33.3,11,15,10,7,1,0,6,8,14,8,0,Matches,Liverpool
Takumi Minamino,jp JPN,"FW,MF",24,2.8,4,3,1,3,0,1,7,14.3,6,63,20,31.7,11,27,25,3,0,0,3,0,4,2,0,Matches,Liverpool
Xherdan Shaqiri,ch SUI,FW,27,2.1,1,0,0,1,0,0,0,,0,39,12,30.8,11,13,15,1,0,0,1,0,1,0,0,Matches,Liverpool
Curtis Jones,eng ENG,MF,18,1.4,3,2,0,1,2,2,3,66.7,1,27,7,25.9,5,8,14,3,0,0,3,2,5,1,0,Matches,Liverpool
Harvey Elliot,eng ENG,DF,16,0.1,0,0,0,0,0,0,0,,0,0,0,,0,0,0,0,0,0,0,0,0,0,0,Matches,Liverpool
Ederson,br BRA,GK,25,34.1,1,1,1,0,0,1,2,50.0,1,7,2,28.6,7,0,0,0,0,0,0,2,3,2,4,Matches,Manchester City
Kevin De Bruyne,be BEL,MF,28,31.0,44,28,11,18,15,11,58,19.0,47,554,177,31.9,83,230,241,31,2,0,29,19,63,19,1,Matches,Manchester City
Raheem Sterling,eng ENG,FW,24,29.5,41,29,8,19,14,10,33,30.3,23,412,132,32.0,67,177,168,25,3,0,22,14,55,8,0,Matches,Manchester City
Rodri,es ESP,MF,23,27.6,64,44,23,33,8,28,68,41.2,40,462,137,29.7,142,254,66,28,6,0,22,28,92,61,0,Matches,Manchester City
Kyle Walker,eng ENG,DF,29,26.6,33,23,14,17,2,19,33,57.6,14,256,101,39.5,93,119,44,31,6,1,25,29,62,64,0,Matches,Manchester City
Fernandinho,br BRA,DF,34,26.6,44,25,29,15,0,18,47,38.3,29,217,89,41.0,106,90,21,40,17,1,23,25,69,106,1,Matches,Manchester City
Bernardo Silva,pt POR,"FW,MF",24,22.6,39,26,15,14,10,15,49,30.6,34,408,124,30.4,63,179,166,36,1,0,35,26,65,11,0,Matches,Manchester City
David Silva,es ESP,MF,33,20.3,26,16,3,14,9,10,25,40.0,15,302,96,31.8,32,150,120,21,4,0,17,12,38,7,1,Matches,Manchester City
Gabriel Jesus,br BRA,FW,22,22.6,25,19,4,9,12,5,25,20.0,20,419,127,30.3,25,154,240,31,4,0,27,14,39,7,0,Matches,Manchester City
İlkay Gündoğan,de GER,MF,28,22.4,28,19,6,15,7,10,47,21.3,37,255,73,28.6,65,135,55,25,5,0,20,30,58,21,0,Matches,Manchester City
Riyad Mahrez,dz ALG,FW,28,21.6,32,21,9,13,10,13,48,27.1,35,394,111,28.2,72,154,168,38,1,0,37,19,51,7,0,Matches,Manchester City
Nicolás Otamendi,ar ARG,DF,31,19.1,22,12,19,2,1,13,31,41.9,18,109,36,33.0,65,38,6,28,11,1,17,19,41,89,2,Matches,Manchester City
Benjamin Mendy,fr FRA,DF,25,16.6,22,17,9,8,5,10,29,34.5,19,142,41,28.9,59,52,31,21,2,0,19,17,39,43,3,Matches,Manchester City
Sergio Agüero,ar ARG,FW,31,16.1,7,5,0,4,3,1,6,16.7,5,222,56,25.2,13,74,135,15,2,0,13,3,10,3,0,Matches,Manchester City
Aymeric Laporte,fr FRA,DF,25,12.2,12,8,8,4,0,7,13,53.8,6,62,26,41.9,32,27,3,6,5,0,1,19,31,39,2,Matches,Manchester City
Oleksandr Zinchenko,ua UKR,DF,22,14.2,28,16,15,11,2,17,39,43.6,22,139,45,32.4,45,57,37,20,0,0,20,15,43,36,1,Matches,Manchester City
João Cancelo,pt POR,DF,25,13.4,44,26,23,13,8,18,44,40.9,26,174,59,33.9,67,71,36,12,2,0,10,22,66,27,1,Matches,Manchester City
John Stones,eng ENG,DF,25,12.5,19,12,10,7,2,4,8,50.0,4,90,39,43.3,47,38,5,15,3,0,12,8,27,38,1,Matches,Manchester City
Phil Foden,eng ENG,"FW,MF",19,10.0,16,9,5,8,3,7,17,41.2,10,253,74,29.2,43,105,105,9,0,0,9,7,23,3,0,Matches,Manchester City
Eric García,es ESP,DF,18,8.8,12,4,8,3,1,6,11,54.5,5,74,20,27.0,44,25,5,8,0,0,8,18,30,46,1,Matches,Manchester City
Angeliño,es ESP,DF,22,4.7,8,5,4,3,1,5,6,83.3,1,47,18,38.3,14,25,8,4,0,0,4,9,17,18,0,Matches,Manchester City
Claudio Bravo,cl CHI,GK,36,3.9,0,0,0,0,0,0,0,,0,0,0,,0,0,0,0,0,0,0,0,0,0,1,Matches,Manchester City
Thomas Doyle,eng ENG,"MF,FW",17,0.2,0,0,0,0,0,0,0,,0,5,1,20.0,1,3,1,0,0,0,0,0,0,0,0,Matches,Manchester City
Leroy Sané,de GER,FW,23,0.1,0,0,0,0,0,0,0,,0,0,0,,0,0,0,0,0,0,0,0,0,0,0,Matches,Manchester City
David de Gea,es ESP,GK,28,38.0,0,0,0,0,0,0,0,,0,1,0,0.0,1,0,0,0,0,0,0,0,0,1,2,Matches,Manchester Utd
Harry Maguire,eng ENG,DF,26,38.0,44,27,25,18,1,14,36,38.9,22,240,90,37.5,155,77,8,45,25,0,20,75,119,246,1,Matches,Manchester Utd
Victor Lindelöf,se SWE,DF,25,34.4,30,16,21,8,1,12,17,70.6,5,221,64,29.0,117,98,6,50,21,0,29,26,56,170,0,Matches,Manchester Utd
Aaron Wan-Bissaka,eng ENG,DF,21,34.1,138,65,82,48,8,45,73,61.6,28,611,176,28.8,304,228,79,101,14,0,87,65,203,108,0,Matches,Manchester Utd
Marcus Rashford,eng ENG,FW,21,29.4,12,6,1,7,4,7,28,25.0,21,378,102,27.0,32,175,171,26,0,0,26,9,21,20,0,Matches,Manchester Utd
Anthony Martial,fr FRA,FW,23,29.2,15,12,1,4,10,1,13,7.7,12,379,108,28.5,23,128,228,19,1,0,18,4,19,16,0,Matches,Manchester Utd
Daniel James,wal WAL,FW,21,25.4,25,15,6,12,7,6,45,13.3,39,569,143,25.1,124,263,182,37,4,0,33,8,33,10,0,Matches,Manchester Utd
Fred,br BRA,MF,26,24.0,79,51,41,33,5,29,98,29.6,69,707,194,27.4,289,328,90,64,8,0,56,38,117,26,0,Matches,Manchester Utd
Scott McTominay,sco SCO,MF,22,19.7,50,31,20,26,4,17,38,44.7,21,262,84,32.1,94,138,30,39,6,0,33,33,83,52,0,Matches,Manchester Utd
Luke Shaw,eng ENG,DF,24,19.3,34,24,18,10,6,15,35,42.9,20,274,78,28.5,120,118,36,53,7,0,46,22,56,58,0,Matches,Manchester Utd
Nemanja Matić,rs SRB,MF,30,17.6,41,21,18,22,1,9,33,27.3,24,276,79,28.6,103,151,22,33,9,0,24,23,64,35,1,Matches,Manchester Utd
Andreas Pereira,br BRA,"MF,FW",23,16.5,22,12,5,11,6,10,42,23.8,32,429,114,26.6,79,235,115,24,0,0,24,6,28,6,0,Matches,Manchester Utd
Bruno Fernandes,pt POR,MF,24,13.2,19,14,7,8,4,5,34,14.7,29,260,65,25.0,59,124,77,14,0,0,14,9,28,12,0,Matches,Manchester Utd
Paul Pogba,fr FRA,MF,26,13.4,25,16,11,10,4,8,19,42.1,11,165,58,35.2,61,71,33,20,7,0,13,5,30,13,1,Matches,Manchester Utd
Mason Greenwood,eng ENG,FW,17,14.7,19,13,6,6,7,7,21,33.3,14,190,61,32.1,50,75,65,15,0,0,15,8,27,4,0,Matches,Manchester Utd
Brandon Williams,eng ENG,DF,18,11.2,19,5,12,5,2,8,28,28.6,20,166,40,24.1,74,63,29,36,6,0,30,11,30,23,0,Matches,Manchester Utd
Ashley Young,eng ENG,DF,34,10.6,10,4,4,3,3,2,21,9.5,19,119,35,29.4,47,57,15,24,2,0,22,10,20,30,0,Matches,Manchester Utd
Jesse Lingard,eng ENG,"MF,FW",26,10.4,13,9,5,2,6,4,15,26.7,11,336,80,23.8,62,173,101,9,1,0,8,2,15,1,0,Matches,Manchester Utd
Juan Mata,es ESP,"MF,FW",31,8.4,8,7,2,4,2,2,13,15.4,11,118,35,29.7,18,54,46,7,1,0,6,0,8,1,0,Matches,Manchester Utd
Axel Tuanzebe,eng ENG,DF,21,2.1,3,3,0,3,0,0,1,0.0,1,30,8,26.7,12,14,4,7,0,0,7,5,8,6,1,Matches,Manchester Utd
Timothy Fosu-Mensah,nl NED,DF,21,1.5,1,1,1,0,0,1,4,25.0,3,19,5,26.3,9,9,1,0,0,0,0,5,6,2,0,Matches,Manchester Utd
Phil Jones,eng ENG,DF,27,1.5,4,2,2,2,0,2,2,100.0,0,18,9,50.0,12,5,1,1,0,0,1,4,8,19,1,Matches,Manchester Utd
Eric Bailly,ci CIV,DF,25,1.7,0,0,0,0,0,0,1,0.0,1,17,4,23.5,10,7,0,3,3,0,0,3,3,7,0,Matches,Manchester Utd
Marcos Rojo,ar ARG,DF,29,1.4,2,1,1,1,0,0,3,0.0,3,16,4,25.0,6,9,1,1,1,0,0,0,2,9,0,Matches,Manchester Utd
Diogo Dalot,pt POR,DF,20,0.7,3,2,3,0,0,2,4,50.0,2,8,4,50.0,3,2,3,1,0,0,1,2,5,4,0,Matches,Manchester Utd
Odion Ighalo,ng NGA,FW,30,1.1,2,2,0,2,0,1,2,50.0,1,23,5,21.7,4,6,13,2,1,0,1,0,2,0,0,Matches,Manchester Utd
Tahith Chong,nl NED,"FW,MF",19,0.4,0,0,0,0,0,0,0,,0,15,4,26.7,4,3,8,0,0,0,0,0,0,0,0,Matches,Manchester Utd
Angel Gomes,eng ENG,MF,18,0.2,0,0,0,0,0,0,0,,0,11,1,9.1,6,4,1,1,0,0,1,0,0,0,0,Matches,Manchester Utd
James Garner,eng ENG,MF,18,0.1,0,0,0,0,0,0,1,0.0,1,2,0,0.0,0,2,0,0,0,0,0,0,0,1,0,Matches,Manchester Utd
Martin Dúbravka,sk SVK,GK,30,38.0,0,0,0,0,0,0,1,0.0,1,9,0,0.0,9,0,0,2,0,0,2,1,1,1,3,Matches,Newcastle Utd
Miguel Almirón,py PAR,"MF,FW",25,33.6,62,36,34,17,11,13,46,28.3,33,732,175,23.9,236,278,218,44,1,0,43,30,92,16,0,Matches,Newcastle Utd
Joelinton,br BRA,FW,22,29.8,30,19,5,17,8,11,35,31.4,24,595,135,22.7,73,311,211,33,7,1,26,11,41,28,0,Matches,Newcastle Utd
Federico Fernández,ar ARG,DF,30,29.1,50,32,41,8,1,27,51,52.9,24,231,73,31.6,170,48,13,61,31,0,30,22,72,214,1,Matches,Newcastle Utd
Isaac Hayden,eng ENG,MF,24,24.7,63,37,35,20,8,12,45,26.7,33,476,126,26.5,213,203,60,38,8,0,30,36,99,34,1,Matches,Newcastle Utd
Jonjo Shelvey,eng ENG,MF,27,23.5,30,16,15,14,1,8,41,19.5,33,392,88,22.4,173,189,30,26,5,0,21,22,52,54,0,Matches,Newcastle Utd
Jamaal Lascelles,eng ENG,DF,25,23.1,18,10,14,4,0,5,14,35.7,9,163,60,36.8,110,47,6,37,23,0,14,29,47,165,1,Matches,Newcastle Utd
Allan Saint-Maximin,fr FRA,"MF,FW",22,20.7,17,11,11,2,4,5,25,20.0,20,251,62,24.7,75,113,63,21,3,0,18,9,26,6,0,Matches,Newcastle Utd
Fabian Schär,ch SUI,"DF,MF",27,18.6,49,27,35,12,2,22,48,45.8,26,225,60,26.7,149,68,8,44,21,1,23,51,100,104,2,Matches,Newcastle Utd
Javier Manquillo,es ESP,DF,25,17.8,47,32,32,11,4,24,39,61.5,15,220,71,32.3,120,77,23,35,5,0,30,20,67,60,0,Matches,Newcastle Utd
Jetro Willems,nl NED,DF,25,16.6,32,19,27,4,1,10,32,31.3,22,230,65,28.3,140,66,24,32,7,0,25,16,48,49,0,Matches,Newcastle Utd
Sean Longstaff,eng ENG,MF,21,15.3,43,21,19,20,4,20,54,37.0,34,513,112,21.8,208,247,58,31,3,0,28,21,64,30,2,Matches,Newcastle Utd
Matt Ritchie,sco SCO,"DF,MF",29,14.6,24,17,11,10,3,4,17,23.5,13,208,49,23.6,89,70,49,27,4,0,23,12,36,36,0,Matches,Newcastle Utd
Paul Dummett,wal WAL,DF,27,13.6,28,6,18,6,4,12,20,60.0,8,163,40,24.5,97,58,8,42,10,0,32,19,47,72,0,Matches,Newcastle Utd
Ciaran Clark,ie IRL,DF,29,13.2,22,12,20,2,0,3,7,42.9,4,122,44,36.1,88,28,6,25,13,0,12,13,35,98,0,Matches,Newcastle Utd
Emil Krafth,se SWE,DF,24,11.3,20,12,16,2,2,6,21,28.6,15,134,40,29.9,85,36,13,20,9,0,11,9,29,40,0,Matches,Newcastle Utd
DeAndre Yedlin,us USA,DF,26,10.4,19,14,13,5,1,4,12,33.3,8,181,38,21.0,97,49,35,26,8,2,18,9,28,21,0,Matches,Newcastle Utd
Danny Rose,eng ENG,DF,29,9.6,26,15,15,10,1,9,20,45.0,11,92,29,31.5,57,30,5,11,1,0,10,9,35,21,0,Matches,Newcastle Utd
Dwight Gayle,eng ENG,FW,28,9.4,13,10,5,7,1,2,5,40.0,3,118,33,28.0,19,54,45,10,5,0,5,2,15,8,0,Matches,Newcastle Utd
Nabil Bentaleb,dz ALG,MF,24,8.3,30,23,20,10,0,9,25,36.0,16,177,60,33.9,72,95,10,14,2,0,12,19,49,12,0,Matches,Newcastle Utd
Christian Atsu,gh GHA,"FW,MF",27,8.3,12,9,4,6,2,4,15,26.7,11,243,47,19.3,98,105,40,28,1,0,27,2,14,6,0,Matches,Newcastle Utd
Matthew Longstaff,eng ENG,MF,19,6.4,6,3,3,3,0,1,11,9.1,10,189,34,18.0,74,102,13,3,1,1,2,6,12,2,0,Matches,Newcastle Utd
Andy Carroll,eng ENG,FW,30,7.0,7,1,3,1,3,2,8,25.0,6,82,26,31.7,14,38,30,7,3,0,4,1,8,21,0,Matches,Newcastle Utd
Valentino Lazaro,at AUT,"DF,MF",23,5.3,11,2,9,2,0,6,14,42.9,8,98,22,22.4,46,40,12,6,0,0,6,3,14,4,0,Matches,Newcastle Utd
Florian Lejeune,fr FRA,DF,28,4.9,8,6,6,2,0,5,9,55.6,4,58,19,32.8,39,18,1,13,2,0,11,11,19,27,1,Matches,Newcastle Utd
Yoshinori Mutō,jp JPN,"FW,MF",27,2.4,3,2,0,3,0,0,3,0.0,3,52,13,25.0,7,24,21,1,0,0,1,0,3,0,0,Matches,Newcastle Utd
Ki Sung-yueng,kr KOR,MF,30,1.5,1,1,1,0,0,0,2,0.0,2,39,4,10.3,21,15,3,1,0,0,1,2,3,3,0,Matches,Newcastle Utd
Kelland Watts,eng ENG,DF,19,0.2,1,0,1,0,0,1,1,100.0,0,0,0,,0,0,0,0,0,0,0,0,1,0,0,Matches,Newcastle Utd
Max Aarons,eng ENG,DF,19,36.0,64,36,40,17,7,21,45,46.7,24,485,132,27.2,281,142,62,100,30,2,70,35,99,86,0,Matches,Norwich City
Tim Krul,nl NED,GK,31,36.0,0,0,0,0,0,0,1,0.0,1,7,1,14.3,7,0,0,0,0,0,0,1,1,1,1,Matches,Norwich City
Teemu Pukki,fi FIN,FW,29,32.1,17,12,4,5,8,2,37,5.4,35,602,160,26.6,48,245,309,22,3,0,19,6,23,9,0,Matches,Norwich City
Kenny McLean,sco SCO,MF,27,33.0,48,31,26,18,4,16,53,30.2,37,589,160,27.2,226,278,85,47,8,1,39,38,86,69,1,Matches,Norwich City
Ben Godfrey,eng ENG,DF,21,29.4,34,22,26,7,1,12,24,50.0,12,234,77,32.9,162,65,7,47,32,0,15,26,60,173,4,Matches,Norwich City
Todd Cantwell,eng ENG,"FW,MF",21,27.7,49,29,22,21,6,19,82,23.2,63,575,149,25.9,184,261,130,58,5,0,53,16,65,35,0,Matches,Norwich City
Emi Buendía,ar ARG,"FW,MF",22,27.4,88,58,62,18,8,26,112,23.2,86,790,207,26.2,308,334,148,69,5,1,64,22,110,29,1,Matches,Norwich City
Alexander Tettey,no NOR,"MF,DF",33,26.0,31,20,11,18,2,12,43,27.9,31,383,98,25.6,182,179,22,40,15,0,25,43,74,85,0,Matches,Norwich City
Jamal Lewis,nir NIR,DF,21,25.6,56,31,45,6,5,18,44,40.9,26,370,112,30.3,231,98,41,55,12,0,43,28,84,68,1,Matches,Norwich City
Christoph Zimmermann,de GER,DF,26,15.9,31,21,23,7,1,16,25,64.0,9,123,38,30.9,92,30,1,33,23,1,10,18,49,123,1,Matches,Norwich City
Sam Byram,eng ENG,DF,25,14.4,46,23,28,11,7,24,49,49.0,25,236,74,31.4,126,83,27,50,10,0,40,24,70,75,0,Matches,Norwich City
Onel Hernández,cu CUB,"FW,MF",26,15.4,37,27,17,10,10,13,32,40.6,19,244,84,34.4,96,86,62,21,2,1,19,19,56,10,0,Matches,Norwich City
Grant Hanley,sco SCO,DF,27,14.0,27,17,16,11,0,11,19,57.9,8,143,50,35.0,97,43,3,34,20,0,14,30,57,103,1,Matches,Norwich City
Marco Stiepermann,de GER,MF,28,13.1,18,7,9,7,2,6,22,27.3,16,257,53,20.6,47,132,78,15,4,0,11,5,23,16,0,Matches,Norwich City
Tom Trybull,de GER,MF,26,12.6,49,30,26,18,5,18,66,27.3,48,394,113,28.7,175,202,17,21,7,0,14,16,65,38,0,Matches,Norwich City
Ondrej Duda,sk SVK,MF,24,8.0,19,15,10,6,3,7,20,35.0,13,197,54,27.4,52,105,40,18,2,0,16,6,25,7,0,Matches,Norwich City
Ibrahim Amadou,fr FRA,"DF,MF",26,8.4,21,7,12,8,1,3,11,27.3,8,107,26,24.3,64,40,3,8,6,0,2,17,38,58,1,Matches,Norwich City
Lukas Rupp,de GER,"FW,MF",28,7.7,13,9,7,3,3,2,15,13.3,13,192,48,25.0,80,83,29,17,1,0,16,14,27,4,1,Matches,Norwich City
Moritz Leitner,de GER,MF,26,7.6,18,9,10,6,2,5,20,25.0,15,160,33,20.6,85,49,26,18,5,0,13,8,26,6,0,Matches,Norwich City
Timm Klose,ch SUI,DF,31,6.5,9,4,4,5,0,5,11,45.5,6,54,24,44.4,37,17,0,11,6,0,5,8,17,29,2,Matches,Norwich City
Mario Vrančić,ba BIH,MF,30,7.1,27,14,13,13,1,13,27,48.1,14,132,31,23.5,60,51,21,14,1,0,13,8,35,7,1,Matches,Norwich City
Josip Drmić,ch SUI,"FW,MF",26,7.2,4,3,2,1,1,1,11,9.1,10,133,35,26.3,24,54,55,8,0,0,8,1,5,5,1,Matches,Norwich City
Adam Idah,ie IRL,"FW,MF",18,2.5,4,4,2,1,1,1,3,33.3,2,36,9,25.0,9,14,13,6,0,0,6,0,4,1,0,Matches,Norwich City
Michael McGovern,nir NIR,GK,35,1.8,0,0,0,0,0,0,0,,0,0,0,,0,0,0,0,0,0,0,0,0,0,0,Matches,Norwich City
Ralf Fährmann,de GER,GK,30,0.2,0,0,0,0,0,0,0,,0,0,0,,0,0,0,0,0,0,0,0,0,0,0,Matches,Norwich City
Dennis Srbeny,de GER,"MF,FW",25,0.5,5,4,3,2,0,1,3,33.3,2,20,9,45.0,4,9,7,0,0,0,0,0,5,1,0,Matches,Norwich City
Josh Martin,eng ENG,FW,17,0.4,0,0,0,0,0,0,0,,0,13,2,15.4,6,3,4,1,0,0,1,1,1,0,0,Matches,Norwich City
Patrick Roberts,eng ENG,"MF,FW",22,0.3,0,0,0,0,0,0,0,,0,4,1,25.0,2,2,0,0,0,0,0,0,0,0,0,Matches,Norwich City
Akin Famewo,eng ENG,MF,20,0.0,0,0,0,0,0,0,0,,0,0,0,,0,0,0,0,0,0,0,0,0,0,0,Matches,Norwich City
Jordan Thomas,eng ENG,FW,,0.0,0,0,0,0,0,0,0,,0,0,0,,0,0,0,0,0,0,0,0,0,0,0,Matches,Norwich City
George Baldock,eng ENG,DF,26,38.0,74,45,44,17,13,25,48,52.1,23,564,158,28.0,243,209,112,63,5,0,58,37,111,87,3,Matches,Sheffield Utd
Enda Stevens,ie IRL,DF,29,37.2,76,43,43,25,8,24,74,32.4,50,609,162,26.6,277,225,107,76,6,0,70,36,112,89,2,Matches,Sheffield Utd
Chris Basham,eng ENG,DF,31,36.0,84,50,57,23,4,32,79,40.5,47,416,135,32.5,264,119,33,57,19,1,38,73,157,264,2,Matches,Sheffield Utd
Oliver Norwood,nir NIR,MF,28,34.3,75,44,42,27,6,23,91,25.3,68,586,162,27.6,266,258,62,46,13,0,33,51,126,64,0,Matches,Sheffield Utd
Dean Henderson,eng ENG,GK,22,36.0,0,0,0,0,0,0,0,,0,1,0,0.0,1,0,0,1,0,0,1,0,0,3,0,Matches,Sheffield Utd
John Egan,ie IRL,DF,26,35.4,45,27,32,13,0,21,45,46.7,24,296,101,34.1,209,80,7,73,33,0,40,56,101,270,4,Matches,Sheffield Utd
Jack O'Connell,eng ENG,DF,25,32.4,35,20,22,10,3,14,29,48.3,15,266,91,34.2,152,89,25,75,21,0,54,41,76,214,1,Matches,Sheffield Utd
John Fleck,sco SCO,MF,27,28.0,38,24,17,15,6,18,74,24.3,56,551,146,26.5,150,289,112,44,3,0,41,24,62,24,0,Matches,Sheffield Utd
John Lundstram,eng ENG,MF,25,27.3,50,33,22,18,10,19,68,27.9,49,605,172,28.4,173,302,130,29,4,0,25,33,83,51,0,Matches,Sheffield Utd
Oliver McBurnie,sco SCO,FW,23,23.5,35,21,9,20,6,7,39,17.9,32,619,150,24.2,57,291,271,33,3,0,30,18,53,43,0,Matches,Sheffield Utd
David McGoldrick,ie IRL,FW,31,20.2,42,26,10,23,9,5,17,29.4,12,460,118,25.7,46,241,173,20,3,1,17,3,45,24,0,Matches,Sheffield Utd
Sander Berge,no NOR,MF,21,10.5,26,17,5,15,6,6,15,40.0,9,248,63,25.4,52,132,64,28,1,0,27,10,36,16,0,Matches,Sheffield Utd
Lys Mousset,fr FRA,FW,23,13.8,11,4,2,5,4,2,7,28.6,5,296,83,28.0,12,120,164,10,3,0,7,4,15,2,0,Matches,Sheffield Utd
Billy Sharp,eng ENG,FW,33,11.7,9,5,3,2,4,1,4,25.0,3,217,55,25.3,16,91,110,4,0,0,4,1,10,1,0,Matches,Sheffield Utd
Callum Robinson,ie IRL,FW,24,7.5,4,4,1,1,2,1,4,25.0,3,178,50,28.1,29,80,69,4,0,0,4,5,9,2,0,Matches,Sheffield Utd
Ben Osborn,eng ENG,"MF,DF",24,6.6,18,10,14,3,1,4,15,26.7,11,163,40,24.5,58,70,35,17,1,0,16,6,24,10,0,Matches,Sheffield Utd
Jack Robinson,eng ENG,DF,25,5.6,9,3,5,4,0,5,10,50.0,5,53,16,30.2,32,19,2,15,5,0,10,7,16,39,0,Matches,Sheffield Utd
Luke Freeman,eng ENG,MF,27,4.1,5,4,1,2,2,2,9,22.2,7,96,24,25.0,31,42,23,9,0,0,9,9,14,6,0,Matches,Sheffield Utd
Muhamed Bešić,ba BIH,MF,26,2.8,9,6,6,3,0,2,6,33.3,4,71,17,23.9,29,33,9,4,0,0,4,2,11,5,0,Matches,Sheffield Utd
Phil Jagielka,eng ENG,DF,36,2.7,6,4,4,2,0,1,6,16.7,5,26,9,34.6,18,8,0,9,5,0,4,4,10,26,0,Matches,Sheffield Utd
Simon Moore,eng ENG,GK,29,2.0,0,0,0,0,0,0,1,0.0,1,3,0,0.0,3,0,0,0,0,0,0,0,0,0,0,Matches,Sheffield Utd
Richairo Živković,nl NED,FW,22,1.2,2,2,0,2,0,0,1,0.0,1,39,13,33.3,2,17,20,1,0,0,1,0,2,0,0,Matches,Sheffield Utd
Leon Clarke,eng ENG,"FW,MF",34,0.4,0,0,0,0,0,0,0,,0,17,5,29.4,2,7,8,0,0,0,0,0,0,2,0,Matches,Sheffield Utd
Jack Rodwell,eng ENG,MF,28,0.2,0,0,0,0,0,0,0,,0,1,0,0.0,1,0,0,0,0,0,0,0,0,1,0,Matches,Sheffield Utd
Ravel Morrison,eng ENG,MF,26,0.1,0,0,0,0,0,0,0,,0,3,1,33.3,0,1,2,0,0,0,0,0,0,0,0,Matches,Sheffield Utd
Kieron Freeman,wal WAL,FW,27,0.1,0,0,0,0,0,0,0,,0,2,0,0.0,0,1,1,0,0,0,0,0,0,0,0,Matches,Sheffield Utd
James Ward-Prowse,eng ENG,"MF,DF",24,38.0,95,56,31,52,12,37,105,35.2,68,826,244,29.5,286,409,131,67,14,0,53,54,149,109,2,Matches,Southampton
Jan Bednarek,pl POL,DF,23,34.0,70,38,47,16,7,32,73,43.8,41,321,102,31.8,205,103,13,61,26,0,35,74,144,329,4,Matches,Southampton
Danny Ings,eng ENG,FW,27,31.2,51,32,17,24,10,15,69,21.7,54,859,227,26.4,148,363,348,64,5,0,59,12,63,24,0,Matches,Southampton
Nathan Redmond,eng ENG,"MF,FW",25,30.7,57,46,16,25,16,19,64,29.7,45,643,193,30.0,164,254,225,39,2,0,37,15,72,13,0,Matches,Southampton
Ryan Bertrand,eng ENG,DF,29,30.5,48,28,20,19,9,19,55,34.5,36,385,142,36.9,139,162,84,52,13,0,39,31,79,76,1,Matches,Southampton
Pierre Højbjerg,dk DEN,MF,23,30.6,90,57,43,40,7,36,103,35.0,67,632,212,33.5,206,338,88,63,6,0,57,45,135,78,2,Matches,Southampton
Alex McCarthy,eng ENG,GK,29,28.0,0,0,0,0,0,0,0,,0,1,1,100.0,1,0,0,0,0,0,0,0,0,0,2,Matches,Southampton
Jack Stephens,eng ENG,DF,25,27.2,56,35,41,14,1,21,49,42.9,28,223,78,35.0,145,70,8,60,26,0,34,30,86,183,2,Matches,Southampton
Oriol Romeu,es ESP,MF,27,20.7,56,39,22,28,6,29,83,34.9,54,441,141,32.0,169,222,50,58,15,0,43,32,88,56,0,Matches,Southampton
Stuart Armstrong,sco SCO,MF,27,19.1,49,25,27,14,8,13,46,28.3,33,407,129,31.7,115,187,105,24,5,0,19,10,59,22,1,Matches,Southampton
Jannik Vestergaard,dk DEN,DF,26,16.6,25,12,19,5,1,8,28,28.6,20,134,49,36.6,86,45,3,22,9,0,13,24,49,163,1,Matches,Southampton
Cédric Soares,pt POR,DF,27,14.5,46,24,22,21,3,18,38,47.4,20,298,92,30.9,144,114,40,37,4,0,33,18,64,59,0,Matches,Southampton
Shane Long,ie IRL,FW,32,15.5,19,15,5,10,4,5,22,22.7,17,315,98,31.1,31,120,164,18,4,0,14,3,22,12,1,Matches,Southampton
Che Adams,eng ENG,FW,23,12.3,8,6,2,4,2,0,5,0.0,5,231,58,25.1,9,97,125,10,1,0,9,2,10,10,0,Matches,Southampton
Moussa Djenepo,ml MLI,"MF,DF",21,10.3,29,18,18,6,5,8,23,34.8,15,265,79,29.8,67,120,78,24,2,0,22,10,39,12,0,Matches,Southampton
Angus Gunn,eng ENG,GK,23,10.0,0,0,0,0,0,0,1,0.0,1,3,1,33.3,3,0,0,0,0,0,0,0,0,0,0,Matches,Southampton
Yan Valery,fr FRA,DF,20,8.7,21,13,12,6,3,5,20,25.0,15,171,49,28.7,84,52,35,19,2,0,17,12,33,40,2,Matches,Southampton
Sofiane Boufal,ma MAR,"MF,FW",25,8.5,21,12,10,8,3,3,13,23.1,10,218,71,32.6,54,94,70,17,0,0,17,3,24,2,0,Matches,Southampton
Michael Obafemi,ie IRL,FW,19,7.4,6,2,1,1,4,3,12,25.0,9,179,56,31.3,20,61,98,4,1,0,3,4,10,0,0,Matches,Southampton
Kyle Walker-Peters,eng ENG,DF,22,7.8,14,8,8,4,2,7,21,33.3,14,98,29,29.6,41,46,11,24,3,0,21,13,27,28,1,Matches,Southampton
Maya Yoshida,jp JPN,DF,30,6.2,7,5,4,0,3,2,6,33.3,4,43,12,27.9,27,16,0,11,4,0,7,3,10,41,1,Matches,Southampton
William Smallbone,ie IRL,MF,19,4.4,12,8,3,8,1,4,12,33.3,8,72,27,37.5,13,30,29,10,1,0,9,2,14,3,0,Matches,Southampton
Kevin Danso,at AUT,DF,20,3.1,8,4,4,4,0,5,8,62.5,3,41,10,24.4,26,13,2,9,4,0,5,3,11,15,0,Matches,Southampton
Jake Vokins,eng ENG,DF,19,1.0,2,0,1,1,0,1,1,100.0,0,13,6,46.2,4,5,4,1,0,0,1,0,2,1,0,Matches,Southampton
Nathan Tella,eng ENG,FW,20,0.0,0,0,0,0,0,0,0,,0,2,0,0.0,0,1,1,0,0,0,0,0,0,0,0,Matches,Southampton
Toby Alderweireld,be BEL,DF,30,32.9,44,24,24,17,3,14,36,38.9,22,258,83,32.2,169,79,10,69,34,1,35,26,70,229,3,Matches,Tottenham
Serge Aurier,ci CIV,DF,26,30.0,98,55,66,26,6,32,61,52.5,29,521,153,29.4,262,187,72,58,7,0,51,43,141,105,1,Matches,Tottenham
Harry Kane,eng ENG,FW,26,28.7,20,14,5,13,2,6,19,31.6,13,448,100,22.3,22,219,207,31,12,0,19,5,25,30,0,Matches,Tottenham
Son Heung-min,kr KOR,"FW,MF",27,27.5,33,21,15,15,3,11,66,16.7,55,544,133,24.4,130,247,167,28,0,0,28,19,52,19,0,Matches,Tottenham
Moussa Sissoko,fr FRA,MF,29,27.2,56,35,36,19,1,20,50,40.0,30,437,126,28.8,219,167,51,38,5,0,33,31,87,48,0,Matches,Tottenham
Davinson Sánchez,co COL,DF,23,27.0,49,36,37,12,0,17,52,32.7,35,278,105,37.8,189,83,6,56,29,0,27,34,83,160,2,Matches,Tottenham
Harry Winks,eng ENG,MF,23,24.7,42,23,19,21,2,19,59,32.2,40,435,130,29.9,196,202,37,31,9,0,22,37,79,33,0,Matches,Tottenham
Lucas Moura,br BRA,"FW,MF",26,24.9,53,33,19,21,13,12,60,20.0,48,532,144,27.1,111,284,137,40,2,0,38,15,68,21,0,Matches,Tottenham
Dele Alli,eng ENG,"MF,FW",23,20.5,41,29,10,24,7,8,32,25.0,24,479,135,28.2,108,234,137,53,7,0,46,14,55,17,0,Matches,Tottenham
Hugo Lloris,fr FRA,GK,32,20.1,0,0,0,0,0,0,0,,0,1,0,0.0,1,0,0,0,0,0,0,1,1,1,2,Matches,Tottenham
Jan Vertonghen,be BEL,DF,32,18.3,31,21,17,13,1,10,20,50.0,10,154,51,33.1,98,49,7,30,10,0,20,31,62,116,0,Matches,Tottenham
Paulo Gazzaniga,ar ARG,GK,27,17.9,0,0,0,0,0,0,0,,0,1,0,0.0,1,0,0,0,0,0,0,0,0,0,0,Matches,Tottenham
Ben Davies,wal WAL,DF,26,15.9,29,13,13,13,3,5,24,20.8,19,214,63,29.4,98,91,25,43,13,0,30,24,53,67,1,Matches,Tottenham
Giovani Lo Celso,ar ARG,"MF,FW",23,16.6,51,33,13,31,7,9,53,17.0,44,420,134,31.9,141,211,68,29,6,0,23,12,63,20,1,Matches,Tottenham
Eric Dier,eng ENG,"DF,MF",25,14.9,25,14,13,10,2,6,22,27.3,16,204,54,26.5,92,93,19,26,11,0,15,19,44,78,0,Matches,Tottenham
Érik Lamela,ar ARG,"MF,FW",27,13.5,27,21,8,15,4,5,22,22.7,17,315,88,27.9,81,150,84,19,3,0,16,7,34,8,0,Matches,Tottenham
Tanguy Ndombele,fr FRA,MF,22,11.2,27,19,12,14,1,10,27,37.0,17,226,56,24.8,79,107,40,27,4,0,23,13,40,8,0,Matches,Tottenham
Christian Eriksen,dk DEN,"MF,FW",27,12.2,19,12,12,6,1,5,23,21.7,18,260,55,21.2,83,126,51,19,1,0,18,11,30,11,0,Matches,Tottenham
Danny Rose,eng ENG,DF,29,9.9,16,13,5,7,4,7,17,41.2,10,103,34,33.0,47,35,21,23,7,0,16,7,23,34,0,Matches,Tottenham
Steven Bergwijn,nl NED,"FW,MF",21,7.8,5,4,1,3,1,2,10,20.0,8,117,34,29.1,26,68,23,11,0,0,11,3,8,7,0,Matches,Tottenham
Japhet Tanganga,eng ENG,DF,20,5.8,20,15,14,5,1,9,19,47.4,10,95,30,31.6,52,38,5,12,5,1,7,11,31,33,1,Matches,Tottenham
Ryan Sessegnon,eng ENG,DF,19,3.8,5,0,2,3,0,2,5,40.0,3,51,11,21.6,21,19,11,4,0,0,4,1,6,15,0,Matches,Tottenham
Kyle Walker-Peters,eng ENG,DF,22,2.7,5,3,5,0,0,1,5,20.0,4,36,12,33.3,19,11,6,6,2,0,4,2,7,9,0,Matches,Tottenham
Oliver Skipp,eng ENG,"MF,DF",18,0.9,3,2,1,2,0,1,2,50.0,1,31,6,19.4,14,14,3,3,1,0,2,0,3,0,0,Matches,Tottenham
Juan Foyth,ar ARG,DF,21,0.8,7,4,5,1,1,2,3,66.7,1,14,5,35.7,10,4,0,2,0,0,2,2,9,4,0,Matches,Tottenham
Gedson Fernandes,pt POR,"MF,DF",20,0.8,1,1,1,0,0,0,1,0.0,1,18,5,27.8,7,7,4,1,0,0,1,1,2,0,0,Matches,Tottenham
Victor Wanyama,ke KEN,MF,28,0.3,1,0,0,1,0,0,0,,0,6,0,0.0,2,3,1,0,0,0,0,0,1,1,0,Matches,Tottenham
Troy Parrott,ie IRL,MF,17,0.1,0,0,0,0,0,0,0,,0,4,2,50.0,2,0,2,0,0,0,0,0,0,0,0,Matches,Tottenham
Georges-Kévin N'Koudou,fr FRA,FW,24,0.0,0,0,0,0,0,0,1,0.0,1,7,3,42.9,0,2,5,0,0,0,0,0,0,0,0,Matches,Tottenham
Ben Foster,eng ENG,GK,36,38.0,0,0,0,0,0,0,3,0.0,3,9,0,0.0,9,0,0,1,0,0,1,1,1,1,2,Matches,Watford
Abdoulaye Doucouré,fr FRA,MF,26,35.1,70,49,29,30,11,16,60,26.7,44,947,238,25.1,268,463,216,59,9,0,50,32,102,45,0,Matches,Watford
Étienne Capoue,fr FRA,MF,31,29.2,80,54,43,31,6,34,89,38.2,55,662,172,26.0,288,293,81,53,10,0,43,62,142,70,0,Matches,Watford
Craig Cathcart,nir NIR,DF,30,27.6,37,26,21,15,1,10,30,33.3,20,195,68,34.9,112,75,8,35,16,1,19,22,59,195,2,Matches,Watford
Will Hughes,eng ENG,"MF,FW",24,25.0,80,49,30,37,13,27,86,31.4,59,676,181,26.8,198,334,144,66,9,0,57,35,115,30,0,Matches,Watford
Craig Dawson,eng ENG,DF,29,26.2,30,19,15,13,2,14,31,45.2,17,185,73,39.5,107,66,12,56,35,1,21,34,64,165,1,Matches,Watford
Christian Kabasele,be BEL,DF,28,25.0,40,24,32,8,0,16,36,44.4,20,247,85,34.4,141,88,18,55,28,0,27,37,77,171,2,Matches,Watford
Kiko Femenía,es ESP,DF,28,24.9,62,32,44,15,3,26,71,36.6,45,385,97,25.2,210,139,36,35,2,0,33,37,99,62,1,Matches,Watford
Troy Deeney,eng ENG,FW,31,24.7,24,17,2,14,8,9,30,30.0,21,458,107,23.4,53,226,179,20,2,0,18,11,35,22,0,Matches,Watford
Gerard Deulofeu,es ESP,FW,25,23.3,29,21,15,8,6,13,66,19.7,53,511,133,26.0,113,208,190,16,0,0,16,24,53,6,0,Matches,Watford
Ismaila Sarr,sn SEN,"FW,MF",21,22.5,25,19,13,5,7,5,22,22.7,17,421,103,24.5,107,180,134,20,3,0,17,15,40,6,0,Matches,Watford
Adam Masina,it ITA,DF,25,20.2,40,25,26,11,3,14,45,31.1,31,263,77,29.3,120,105,38,41,13,2,28,28,68,99,2,Matches,Watford
Roberto Pereyra,ar ARG,"FW,MF",28,18.3,17,10,9,4,4,5,29,17.2,24,340,90,26.5,74,155,111,38,1,0,37,12,29,5,1,Matches,Watford
Adrian Mariappa,jm JAM,DF,32,16.8,25,12,18,5,2,11,38,28.9,27,197,57,28.9,114,64,19,35,9,0,26,10,35,93,1,Matches,Watford
José Holebas,gr GRE,DF,35,11.4,25,12,20,5,0,6,25,24.0,19,179,59,33.0,94,63,22,23,3,0,20,2,27,40,0,Matches,Watford
Tom Cleverley,eng ENG,MF,29,10.8,27,17,11,14,2,11,44,25.0,33,293,85,29.0,99,145,49,20,4,0,16,9,36,16,0,Matches,Watford
Nathaniel Chalobah,eng ENG,MF,24,10.3,33,19,10,16,7,9,27,33.3,18,227,65,28.6,76,112,39,13,5,0,8,16,49,32,0,Matches,Watford
Danny Welbeck,eng ENG,"FW,MF",28,9.1,10,9,4,5,1,1,11,9.1,10,168,52,31.0,33,77,58,12,2,0,10,5,15,6,0,Matches,Watford
Andre Gray,eng ENG,FW,28,8.4,5,5,0,1,4,1,1,100.0,0,161,43,26.7,13,61,87,3,1,0,2,1,6,2,0,Matches,Watford
Daryl Janmaat,nl NED,DF,30,6.7,16,6,7,5,4,6,17,35.3,11,137,31,22.6,55,53,29,14,2,0,12,6,22,25,0,Matches,Watford
Dimitri Foulquier,fr FRA,"MF,DF",26,0.7,1,1,1,0,0,0,1,0.0,1,18,6,33.3,6,9,3,2,0,0,2,2,3,1,0,Matches,Watford
Sebastian Prödl,at AUT,DF,32,0.6,0,0,0,0,0,0,0,,0,3,0,0.0,2,1,0,0,0,0,0,0,0,4,0,Matches,Watford
Ignacio Pussetto,ar ARG,"FW,DF",23,0.8,6,3,3,2,1,3,9,33.3,6,38,8,21.1,19,17,2,3,1,1,2,3,9,4,0,Matches,Watford
Isaac Success,ng NGA,"FW,MF",23,0.8,0,0,0,0,0,0,0,,0,14,2,14.3,0,3,11,0,0,0,0,1,1,0,0,Matches,Watford
João Pedro,br BRA,"FW,MF",17,0.3,0,0,0,0,0,0,0,,0,6,1,16.7,1,4,1,0,0,0,0,0,0,1,0,Matches,Watford
Domingos Quina,pt POR,MF,19,0.2,1,0,1,0,0,1,3,33.3,2,16,3,18.8,5,7,4,2,0,0,2,0,1,0,0,Matches,Watford
Declan Rice,eng ENG,MF,20,38.0,122,89,66,52,4,32,95,33.7,63,819,237,28.9,386,385,48,68,9,0,59,78,200,62,0,Matches,West Ham
Mark Noble,eng ENG,MF,32,29.7,50,36,19,25,6,16,69,23.2,53,502,136,27.1,159,255,88,29,6,0,23,21,71,14,0,Matches,West Ham
Angelo Ogbonna,it ITA,DF,31,31.0,45,34,29,12,4,14,36,38.9,22,313,117,37.4,224,73,16,78,34,0,44,32,77,171,0,Matches,West Ham
Issa Diop,fr FRA,DF,22,30.7,32,16,22,10,0,15,32,46.9,17,243,84,34.6,156,79,8,47,21,0,26,46,78,190,3,Matches,West Ham
Aaron Cresswell,eng ENG,DF,29,30.3,48,29,25,18,5,24,59,40.7,35,355,118,33.2,185,130,40,64,10,0,54,35,83,92,2,Matches,West Ham
Ryan Fredericks,eng ENG,DF,26,24.9,86,48,63,15,8,33,65,50.8,32,325,97,29.8,196,85,44,42,9,1,33,26,112,91,0,Matches,West Ham
Łukasz Fabiański,pl POL,GK,34,23.5,0,0,0,0,0,0,3,0.0,3,10,2,20.0,10,0,0,0,0,0,0,1,1,2,2,Matches,West Ham
Sébastien Haller,fr FRA,FW,25,25.2,21,17,10,9,2,3,28,10.7,25,571,126,22.1,43,304,224,34,7,0,27,8,29,24,1,Matches,West Ham
Pablo Fornals,es ESP,"MF,FW",23,24.1,42,29,17,18,7,16,70,22.9,54,597,156,26.1,153,275,169,51,1,0,50,24,66,10,0,Matches,West Ham
Felipe Anderson,br BRA,"MF,FW",26,16.6,45,30,20,18,7,11,48,22.9,37,370,104,28.1,92,189,89,21,1,0,20,21,66,14,0,Matches,West Ham
Michail Antonio,eng ENG,FW,29,19.6,14,10,5,4,5,2,14,14.3,12,337,78,23.1,31,151,155,26,5,0,21,9,23,9,0,Matches,West Ham
Robert Snodgrass,sco SCO,"MF,FW",31,16.8,27,10,17,9,1,10,40,25.0,30,367,90,24.5,118,185,64,21,2,0,19,5,32,16,0,Matches,West Ham
Manuel Lanzini,ar ARG,"MF,FW",26,15.3,11,9,6,3,2,5,37,13.5,32,344,76,22.1,77,198,69,12,1,0,11,9,20,4,0,Matches,West Ham
Fabián Balbuena,py PAR,DF,27,13.1,18,11,14,3,1,6,26,23.1,20,116,40,34.5,91,22,3,27,7,0,20,26,44,93,1,Matches,West Ham
Tomáš Souček,cz CZE,MF,24,11.6,35,25,15,17,3,5,19,26.3,14,240,77,32.1,96,102,42,16,3,0,13,22,57,38,0,Matches,West Ham
Jarrod Bowen,eng ENG,FW,22,10.2,19,13,6,8,5,5,19,26.3,14,174,40,23.0,67,64,43,15,0,0,15,13,32,5,0,Matches,West Ham
Andriy Yarmolenko,ua UKR,"MF,FW",29,11.0,15,10,7,7,1,5,21,23.8,16,167,46,27.5,41,76,50,8,1,0,7,6,21,6,0,Matches,West Ham
Arthur Masuaku,cd COD,DF,25,10.4,43,27,28,12,3,11,30,36.7,19,223,65,29.1,128,81,14,29,3,0,26,13,56,29,1,Matches,West Ham
Roberto,es ESP,GK,33,7.6,0,0,0,0,0,0,0,,0,0,0,,0,0,0,0,0,0,0,0,0,0,0,Matches,West Ham
Pablo Zabaleta,ar ARG,DF,34,6.6,15,10,9,5,1,4,15,26.7,11,93,27,29.0,53,25,15,16,3,0,13,13,28,20,0,Matches,West Ham
Jeremy Ngakia,eng ENG,DF,18,4.9,19,12,16,3,0,7,23,30.4,16,112,34,30.4,79,29,4,11,1,0,10,7,26,17,0,Matches,West Ham
David Martin,eng ENG,GK,33,4.8,0,0,0,0,0,0,0,,0,1,1,100.0,1,0,0,1,0,0,1,0,0,0,1,Matches,West Ham
Ben Johnson,eng ENG,DF,19,3.0,8,4,5,2,1,4,6,66.7,2,36,6,16.7,19,10,7,8,3,0,5,3,11,16,0,Matches,West Ham
Jack Wilshere,eng ENG,MF,27,2.4,1,0,0,1,0,1,6,16.7,5,63,21,33.3,15,34,14,6,0,0,6,1,2,1,0,Matches,West Ham
Darren Randolph,ie IRL,GK,32,2.0,0,0,0,0,0,0,0,,0,0,0,,0,0,0,0,0,0,0,0,0,0,0,Matches,West Ham
Carlos Sánchez,co COL,"MF,DF",33,1.3,2,1,0,2,0,1,1,100.0,0,26,6,23.1,6,18,2,2,0,0,2,2,4,5,0,Matches,West Ham
Javier Hernández,mx MEX,FW,31,1.2,0,0,0,0,0,0,1,0.0,1,26,6,23.1,0,7,19,0,0,0,0,0,0,0,0,Matches,West Ham
Albian Ajeti,ch SUI,"MF,FW",22,1.5,1,0,0,0,1,0,0,,0,21,1,4.8,3,6,12,0,0,0,0,1,2,0,0,Matches,West Ham
Nathan Holland,eng ENG,MF,21,0.4,1,0,1,0,0,0,0,,0,13,4,30.8,5,4,4,1,0,0,1,0,1,0,0,Matches,West Ham
Conor Coady,eng ENG,DF,26,38.0,41,22,34,7,0,19,38,50.0,19,205,69,33.7,151,54,0,37,18,0,19,27,68,164,0,Matches,Wolves
Rui Patrício,pt POR,GK,31,38.0,0,0,0,0,0,0,2,0.0,2,5,0,0.0,5,0,0,1,0,0,1,2,2,1,1,Matches,Wolves
Raúl Jiménez,mx MEX,FW,28,36.0,29,23,7,15,7,2,26,7.7,24,589,141,23.9,33,292,264,32,4,0,28,14,43,31,0,Matches,Wolves
Rúben Neves,pt POR,MF,22,34.0,64,42,26,33,5,32,104,30.8,72,688,170,24.7,301,344,43,70,11,1,59,55,119,53,0,Matches,Wolves
João Moutinho,pt POR,MF,32,34.5,92,54,42,40,10,43,141,30.5,98,882,213,24.1,305,479,98,64,14,0,50,48,140,30,2,Matches,Wolves
Jonny Castro,es ESP,DF,25,32.1,98,61,60,29,9,34,90,37.8,56,722,215,29.8,326,283,113,79,9,0,70,52,150,45,2,Matches,Wolves
Matt Doherty,ie IRL,DF,27,31.5,65,33,36,25,4,26,50,52.0,24,379,107,28.2,181,141,57,64,5,0,59,38,103,78,1,Matches,Wolves
Leander Dendoncker,be BEL,"MF,DF",24,31.1,68,40,41,19,8,23,62,37.1,39,573,164,28.6,251,257,65,53,13,0,40,38,106,95,3,Matches,Wolves
Romain Saïss,ma MAR,DF,29,30.1,66,30,46,20,0,23,45,51.1,22,343,116,33.8,228,106,9,58,19,0,39,51,117,201,1,Matches,Wolves
Adama Traoré,es ESP,"FW,MF",23,28.9,41,23,15,14,12,10,27,37.0,17,404,108,26.7,98,198,108,28,4,0,24,18,59,24,0,Matches,Wolves
Diogo Jota,pt POR,"FW,MF",22,25.4,34,21,13,18,3,12,44,27.3,32,573,127,22.2,124,294,155,17,0,0,17,8,42,9,0,Matches,Wolves
Willy Boly,fr FRA,DF,28,22.0,61,40,42,18,1,23,48,47.9,25,271,101,37.3,181,86,4,50,16,0,34,39,100,136,2,Matches,Wolves
Pedro Neto,pt POR,"FW,MF",19,10.4,11,5,3,8,0,2,15,13.3,13,239,66,27.6,52,123,64,5,0,0,5,7,18,6,0,Matches,Wolves
Ryan Bennett,eng ENG,DF,29,6.7,4,3,4,0,0,2,7,28.6,5,61,15,24.6,41,19,1,15,7,0,8,9,13,45,1,Matches,Wolves
Rúben Vinagre,pt POR,DF,20,7.2,25,13,18,5,2,11,16,68.8,5,117,38,32.5,59,47,11,20,2,0,18,8,33,20,0,Matches,Wolves
Patrick Cutrone,it ITA,FW,21,3.3,6,4,3,1,2,1,5,20.0,4,95,26,27.4,9,43,43,1,1,0,0,2,8,1,0,Matches,Wolves
Daniel Podence,pt POR,"FW,MF",23,3.2,2,2,1,0,1,0,3,0.0,3,43,13,30.2,8,20,15,5,1,0,4,3,5,3,0,Matches,Wolves
Max Kilman,eng ENG,DF,22,2.1,4,3,3,1,0,2,4,50.0,2,17,5,29.4,11,5,1,2,1,0,1,4,8,17,0,Matches,Wolves
Jesús Vallejo,es ESP,DF,22,1.8,4,3,4,0,0,1,3,33.3,2,20,6,30.0,8,10,2,4,3,0,1,1,5,13,0,Matches,Wolves
Morgan Gibbs-White,eng ENG,"MF,FW",19,1.4,1,1,0,1,0,0,0,,0,27,10,37.0,5,15,7,2,0,0,2,1,2,0,0,Matches,Wolves
Bruno Jordão,pt POR,FW,20,0.1,0,0,0,0,0,0,0,,0,0,0,,0,0,0,1,0,0,1,0,0,0,0,Matches,Wolves
